	Cell_Type
AAACCTGAGAATAGGG-1	Pharyngeal arch mesoderm
AAACCTGAGACCCACC-1	Future spinal cord
AAACCTGAGCAGCGTA-1	Visceral endoderm late
AAACCTGAGCCCAATT-1	Angioblasts
AAACCTGAGTACGACG-1	Similar to neural crest
AAACCTGAGTTGTAGA-1	Amnion mesoderm early
AAACCTGCACAGAGGT-1	Primitive blood late
AAACCTGCATAGAAAC-1	Visceral endoderm late
AAACCTGGTAAGGGCT-1	Neural crest
AAACCTGGTCTCATCC-1	Primitive blood late
AAACCTGTCAAAGTAG-1	Allantois
AAACCTGTCCAGAGGA-1	Amnion mesoderm early
AAACCTGTCCGCATAA-1	Future spinal cord
AAACCTGTCCTCAATT-1	Primitive blood progenitors
AAACGGGAGGCTACGA-1	Gut endoderm
AAACGGGAGGGATCTG-1	Primitive blood late
AAACGGGGTCCATCCT-1	Primitive blood late
AAACGGGTCCACTGGG-1	Hematopoietic/endothelial progenitors
AAACGGGTCGCTTAGA-1	Visceral endoderm late
AAAGATGAGAGTAAGG-1	Visceral endoderm late
AAAGATGAGATCCGAG-1	Visceral endoderm early
AAAGATGAGCCAACAG-1	Fore/midbrain
AAAGATGAGGACATTA-1	Visceral endoderm late
AAAGATGGTCGACTAT-1	Allantois
AAAGATGGTGTGGCTC-1	Primitive blood late
AAAGATGTCCATGCTC-1	Future spinal cord
AAAGATGTCGCCAAAT-1	Primitive blood late
AAAGATGTCGGCATCG-1	Primitive blood late
AAAGATGTCTTGAGAC-1	Amnion mesoderm early
AAAGCAAAGAACAACT-1	Primitive blood late
AAAGCAAAGATCCCAT-1	Angioblasts
AAAGCAACACAGACAG-1	Pharyngeal arch mesoderm
AAAGCAATCCTTGGTC-1	Primitive blood late
AAAGTAGAGTAGGTGC-1	Primitive blood late
AAAGTAGCAAGAGTCG-1	Similar to neural crest
AAAGTAGCATGATCCA-1	Visceral endoderm late
AAAGTAGGTAGAGCTG-1	Parietal endoderm
AAAGTAGGTCTGGTCG-1	Somites
AAAGTAGGTGAGGGAG-1	Primitive blood late
AAAGTAGTCCTACAGA-1	Preplacodal ectoderm
AAATGCCAGATCGATA-1	Primitive blood late
AAATGCCAGCTTCGCG-1	Visceral endoderm late
AAATGCCCAATACGCT-1	Angioblasts
AAATGCCTCACGCATA-1	Primitive blood late
AAATGCCTCTTCTGGC-1	Visceral endoderm late
AACACGTAGCACACAG-1	Angioblasts
AACACGTCAAGACGTG-1	Primitive blood late
AACACGTCACTGTCGG-1	Surface ectoderm
AACACGTGTAAACCTC-1	Primitive heart tube
AACACGTGTACGACCC-1	Primitive blood late
AACACGTGTTGGACCC-1	Visceral endoderm late
AACCATGAGAATTGTG-1	Angioblasts
AACCATGAGGTAAACT-1	Primitive blood late
AACCATGAGTCCAGGA-1	Primitive blood progenitors
AACCATGCAATGACCT-1	Visceral endoderm late
AACCATGCAGTATGCT-1	Primitive blood late
AACCATGGTATTAGCC-1	Visceral endoderm late
AACCATGGTCATGCAT-1	Amnion mesoderm early
AACCATGGTTGATTCG-1	Secondary heart field/splanchnic lateral plate
AACCATGTCCGTAGGC-1	Primitive blood early
AACCGCGAGTTTAGGA-1	Future spinal cord
AACCGCGCAGTCCTTC-1	Angioblasts
AACCGCGCATTAGGCT-1	Posterior lateral plate mesoderm
AACCGCGGTAAGTGTA-1	Presomitic mesoderm
AACCGCGGTCAGATAA-1	Splanchnic lateral plate/anterior paraxial mesoderm
AACCGCGGTCTGGAGA-1	Primitive blood late
AACCGCGTCCATGAAC-1	Preplacodal ectoderm
AACCGCGTCGAGCCCA-1	Similar to neural crest
AACCGCGTCTTACCTA-1	Visceral endoderm late
AACGTTGAGTGTACTC-1	Gut endoderm
AACGTTGGTCTTGCGG-1	Hematopoietic/endothelial progenitors
AACGTTGGTGCCTTGG-1	Visceral endoderm late
AACTCAGAGAAACCAT-1	Similar to neural crest
AACTCAGAGGCTCAGA-1	Primitive blood late
AACTCAGAGTAGATGT-1	Trophoblast stem cells
AACTCAGAGTTGTCGT-1	Primitive blood late
AACTCAGGTGGCAAAC-1	Secondary heart field/splanchnic lateral plate
AACTCAGTCCTGTAGA-1	Somites
AACTCAGTCTCTGTCG-1	Visceral endoderm late
AACTCCCAGCATGGCA-1	Primitive blood late
AACTCCCGTCCGAGTC-1	Similar to neural crest
AACTCCCTCACATACG-1	Visceral endoderm late
AACTCCCTCGACGGAA-1	Visceral endoderm early
AACTCTTAGCTTCGCG-1	Visceral endoderm late
AACTCTTAGGCACATG-1	Visceral endoderm late
AACTCTTCAAATCCGT-1	Angioblasts
AACTCTTGTCTAAAGA-1	Visceral endoderm late
AACTCTTGTTCCCTTG-1	Visceral endoderm late
AACTCTTTCGTGGACC-1	Angioblasts
AACTCTTTCTCTAGGA-1	Visceral endoderm late
AACTGGTAGTGCTGCC-1	Preplacodal ectoderm
AACTGGTCAAGCGTAG-1	Visceral endoderm early
AACTTTCAGACACGAC-1	Similar to neural crest
AACTTTCAGCGATGAC-1	Angioblasts
AACTTTCAGCTAGTCT-1	Similar to neural crest
AACTTTCAGGCAGGTT-1	Primitive blood late
AACTTTCGTCAGATAA-1	Secondary heart field/splanchnic lateral plate
AACTTTCGTTGCGCAC-1	Visceral endoderm late
AACTTTCTCGTCGTTC-1	Gut endoderm
AAGACCTAGCCCGAAA-1	Primitive blood late
AAGACCTCACTTCGAA-1	Primitive blood late
AAGACCTGTAATTGGA-1	Visceral endoderm late
AAGACCTGTCAAGCGA-1	Primitive blood late
AAGACCTGTCGATTGT-1	Visceral endoderm late
AAGACCTGTGGAAAGA-1	Visceral endoderm late
AAGACCTTCGCGATCG-1	Similar to neural crest
AAGCCGCAGGTGATTA-1	Angioblasts
AAGCCGCAGGTTACCT-1	Visceral endoderm late
AAGCCGCAGTCCGTAT-1	Primitive blood late
AAGCCGCTCACAGGCC-1	Secondary heart field/splanchnic lateral plate
AAGCCGCTCATCATTC-1	Primitive blood late
AAGGAGCCATACGCTA-1	Visceral endoderm late
AAGGAGCTCATAACCG-1	Angioblasts
AAGGAGCTCCCAAGAT-1	Somites
AAGGCAGAGCGATTCT-1	Secondary heart field/splanchnic lateral plate
AAGGCAGCACAAGCCC-1	Visceral endoderm late
AAGGCAGCACGTTGGC-1	Primitive blood late
AAGGCAGGTCTGATCA-1	Future spinal cord
AAGGCAGTCGCATGAT-1	Visceral endoderm late
AAGGCAGTCTATCGCC-1	Visceral endoderm late
AAGGTTCAGCTCCTTC-1	Visceral endoderm late
AAGGTTCAGGTACTCT-1	Visceral endoderm late
AAGGTTCAGTCGCCGT-1	Primitive blood early
AAGGTTCCAGTTTACG-1	Primitive heart tube
AAGGTTCGTTATCGGT-1	Primitive blood late
AAGGTTCTCCATGCTC-1	Amnion mesoderm early
AAGGTTCTCCGCTGTT-1	Pharyngeal arch mesoderm
AAGGTTCTCGAACGGA-1	Primitive blood late
AAGGTTCTCGGATGGA-1	Visceral endoderm late
AAGTCTGAGCCAGTAG-1	Visceral endoderm late
AAGTCTGCAAGGTTCT-1	Primitive blood late
AAGTCTGCAGGGTACA-1	Primitive blood late
AAGTCTGCAGTGACAG-1	Allantois
AAGTCTGGTCGGGTCT-1	Primitive blood late
AAGTCTGTCAGTTGAC-1	Primitive blood late
AAGTCTGTCCCGGATG-1	Visceral endoderm late
AAGTCTGTCGTACGGC-1	Neuromesodermal progenitor late
AATCCAGAGACTACAA-1	Differentiated trophoblasts
AATCCAGAGCGTTCCG-1	Primitive blood late
AATCCAGAGCTAACAA-1	Similar to neural crest
AATCCAGCAAGAAGAG-1	Primitive heart tube
AATCCAGCATGCAACT-1	Secondary heart field/splanchnic lateral plate
AATCCAGGTAGCGTGA-1	Visceral endoderm late
AATCCAGGTATCGCAT-1	Fore/midbrain
AATCCAGGTCGCATCG-1	Primitive blood late
AATCGGTAGAGCTGGT-1	Pharyngeal arch mesoderm
AATCGGTAGCATCATC-1	Primitive heart tube
AATCGGTCAAGCGAGT-1	Posterior lateral plate mesoderm
AATCGGTCACAAGCCC-1	Preplacodal ectoderm
AATCGGTTCATGCTCC-1	Primitive blood early
ACACCAAAGGGATGGG-1	Amnion mesoderm late
ACACCAAAGTACGATA-1	Visceral endoderm late
ACACCAACAATCTACG-1	Primitive blood late
ACACCAACACATCTTT-1	Visceral endoderm early
ACACCAACACGGTGTC-1	Primitive blood late
ACACCAAGTAACGACG-1	Visceral endoderm late
ACACCAAGTAAGCACG-1	Preplacodal ectoderm
ACACCAATCCCTAACC-1	Primitive blood late
ACACCAATCTTGCATT-1	Differentiated trophoblasts
ACACCCTAGCTGATAA-1	Primitive blood late
ACACCCTCAGAAGCAC-1	Primitive blood late
ACACCCTTCCCTAACC-1	Visceral endoderm late
ACACCGGAGACCTAGG-1	Visceral endoderm early
ACACCGGAGCGTTTAC-1	Similar to neural crest
ACACCGGAGTTAGGTA-1	Pharyngeal arch mesoderm
ACACCGGAGTTGAGTA-1	Angioblasts
ACACCGGCACTGCCAG-1	Visceral endoderm late
ACACCGGCAGTATAAG-1	Presomitic mesoderm
ACACCGGGTAAATGTG-1	Visceral endoderm late
ACACCGGGTCGGCATC-1	Pharyngeal arch mesoderm
ACACTGACACGGCGTT-1	Visceral endoderm late
ACACTGACAGACAGGT-1	Secondary heart field/splanchnic lateral plate
ACACTGACAGATCCAT-1	Angioblasts
ACAGCCGCAAAGGAAG-1	Visceral endoderm late
ACAGCCGCACGCCAGT-1	Visceral endoderm late
ACAGCCGCATGACGGA-1	Visceral endoderm late
ACAGCCGGTGACCAAG-1	Primitive/definitive endoderm
ACAGCCGTCGCCAAAT-1	Visceral endoderm late
ACAGCTAAGGGTCTCC-1	Amnion mesoderm early
ACAGCTAAGGTAGCCA-1	Primitive blood late
ACAGCTACAACCGCCA-1	Angioblasts
ACAGCTACACTGCCAG-1	Amnion mesoderm early
ACAGCTATCATGTGGT-1	Visceral endoderm late
ACATACGAGTTATCGC-1	Visceral endoderm late
ACATACGCACAGACTT-1	Differentiated trophoblasts
ACATACGCACTTCGAA-1	Primitive blood late
ACATACGCAGTAGAGC-1	Primitive blood late
ACATACGGTCACCTAA-1	Posterior lateral plate mesoderm
ACATACGGTGCCTTGG-1	Primitive blood late
ACATACGGTGTTCTTT-1	Visceral endoderm early
ACATACGTCTAACCGA-1	Surface ectoderm
ACATCAGAGCGATCCC-1	Primitive blood late
ACATCAGCAACTTGAC-1	Primitive blood late
ACATCAGCATGAGCGA-1	Visceral endoderm late
ACATCAGTCCACGTTC-1	Visceral endoderm early
ACATCAGTCGATGAGG-1	Similar to neural crest
ACATGGTAGAGTGAGA-1	Visceral endoderm early
ACATGGTGTTCCCTTG-1	Primitive blood late
ACATGGTTCTCGCATC-1	Visceral endoderm late
ACCAGTAAGGCATGGT-1	Similar to neural crest
ACCAGTACACAACGCC-1	Visceral endoderm late
ACCAGTACATTACGAC-1	Visceral endoderm late
ACCAGTATCACTATTC-1	Visceral endoderm early
ACCAGTATCGAACGGA-1	Primitive blood late
ACCAGTATCTCTTGAT-1	Surface ectoderm
ACCCACTCAGATGGCA-1	Visceral endoderm late
ACCCACTGTAAGGGCT-1	Visceral endoderm late
ACCCACTGTTGGTAAA-1	Visceral endoderm late
ACCCACTTCATCACCC-1	Visceral endoderm early
ACCCACTTCGTTTGCC-1	Primitive blood late
ACCCACTTCTATCGCC-1	Primitive blood late
ACCGTAAAGACTAAGT-1	Visceral endoderm late
ACCGTAAAGCACGCCT-1	Primitive blood late
ACCGTAAAGCTAAGAT-1	Primitive blood late
ACCGTAAAGGGCACTA-1	Visceral endoderm late
ACCGTAAGTGATGATA-1	Primitive blood late
ACCGTAAGTTCCACGG-1	Primitive blood late
ACCGTAATCAGCAACT-1	Visceral endoderm late
ACCGTAATCGGCGCAT-1	Primitive blood late
ACCTTTACAAGACGTG-1	Parietal endoderm
ACCTTTACACAGGAGT-1	Somites
ACCTTTACACATGTGT-1	Visceral endoderm late
ACCTTTACATCCCATC-1	Visceral endoderm early
ACCTTTATCAGGTAAA-1	Primitive blood late
ACGAGCCAGCGGATCA-1	Visceral endoderm early
ACGAGCCAGGACACCA-1	Amnion mesoderm early
ACGAGCCAGGACATTA-1	Primitive blood progenitors
ACGAGGAAGCGTTCCG-1	Somites
ACGAGGAAGGCGTACA-1	Primitive blood late
ACGAGGACATCTACGA-1	Visceral endoderm late
ACGAGGACATGAAGTA-1	Primitive blood progenitors
ACGAGGAGTGTAATGA-1	Neuromesodermal progenitor late
ACGAGGATCACAGGCC-1	Visceral endoderm late
ACGAGGATCCGGGTGT-1	Amnion mesoderm late
ACGAGGATCTGCGACG-1	Visceral endoderm late
ACGATACCAAGGACAC-1	Preplacodal ectoderm
ACGATACCAAGTTAAG-1	Somites
ACGATACGTGCATCTA-1	Hematopoietic/endothelial progenitors
ACGATGTCACGAAGCA-1	Visceral endoderm late
ACGATGTCATACGCTA-1	Primitive blood late
ACGATGTCATCGATTG-1	Visceral endoderm early
ACGATGTGTCTAAAGA-1	Pharyngeal arch mesoderm
ACGATGTTCTCAACTT-1	Visceral endoderm late
ACGCAGCAGACCTAGG-1	Neural crest
ACGCAGCAGCAATATG-1	Visceral endoderm late
ACGCAGCAGCCATCGC-1	Visceral endoderm late
ACGCAGCCAATCCGAT-1	Visceral endoderm late
ACGCAGCGTAGCGTGA-1	Similar to neural crest
ACGCAGCGTGCGCTTG-1	Visceral endoderm late
ACGCAGCGTTGTCTTT-1	Parietal endoderm
ACGCAGCTCAGTACGT-1	Visceral endoderm late
ACGCCAGAGGCTCATT-1	Preplacodal ectoderm
ACGCCAGCAAGACACG-1	Posterior lateral plate mesoderm
ACGCCAGCACAGATTC-1	Primitive blood late
ACGCCAGGTTGCGTTA-1	Visceral endoderm late
ACGCCAGGTTTAGGAA-1	Visceral endoderm late
ACGCCAGTCGGAGGTA-1	Similar to neural crest
ACGCCGAAGCAATCTC-1	Amnion mesoderm early
ACGCCGACACCCTATC-1	Visceral endoderm early
ACGCCGAGTCCGACGT-1	Primitive blood late
ACGGAGACATAGACTC-1	Differentiated trophoblasts
ACGGAGAGTATTACCG-1	Parietal endoderm
ACGGAGAGTCCGCTGA-1	Primitive blood late
ACGGAGATCGCGTTTC-1	Visceral endoderm late
ACGGCCAAGATCCTGT-1	Visceral endoderm early
ACGGCCACATTAGGCT-1	Secondary heart field/splanchnic lateral plate
ACGGCCAGTAAGGGCT-1	Primitive blood late
ACGGCCATCTCCAGGG-1	Visceral endoderm early
ACGGCCATCTCTAAGG-1	Amnion mesoderm late
ACGGGCTCAGTGAGTG-1	Differentiated trophoblasts
ACGGGCTTCGGCGCTA-1	Gut endoderm
ACGGGTCAGTCACGCC-1	Amnion mesoderm early
ACGGGTCGTGAGCGAT-1	Distal extraembryonic ectoderm
ACGGGTCTCATCTGTT-1	Angioblasts
ACGTCAAAGCGCCTCA-1	Visceral endoderm early
ACTATCTAGTTAACGA-1	Trophoblast stem cells
ACTATCTCAATAACGA-1	Amnion mesoderm early
ACTATCTCACCTATCC-1	Angioblasts
ACTATCTGTAAAGTCA-1	Visceral endoderm early
ACTATCTTCACGAAGG-1	Primitive blood late
ACTATCTTCGTGACAT-1	Visceral endoderm early
ACTGAACAGGTGACCA-1	Visceral endoderm late
ACTGAACGTTACGTCA-1	Visceral endoderm late
ACTGAGTAGGCTCAGA-1	Visceral endoderm late
ACTGAGTCAATCAGAA-1	Primitive blood early
ACTGAGTCACGAGGTA-1	Visceral endoderm late
ACTGAGTCACTGTGTA-1	Amnion mesoderm late
ACTGAGTCAGGTTTCA-1	Visceral endoderm late
ACTGAGTCATGCCTAA-1	Visceral endoderm late
ACTGAGTGTCAGGACA-1	Visceral endoderm early
ACTGAGTGTGTTCGAT-1	Preplacodal ectoderm
ACTGAGTTCCTATTCA-1	Gut endoderm
ACTGATGAGGGTTCCC-1	Visceral endoderm late
ACTGATGAGTGCGATG-1	Visceral endoderm late
ACTGATGCACGAAGCA-1	Angioblasts
ACTGATGCACTCGACG-1	Parietal endoderm
ACTGATGGTATATGGA-1	Visceral endoderm late
ACTGATGGTCCAGTAT-1	Primitive blood late
ACTGATGGTGTGCCTG-1	Primitive heart tube
ACTGCTCAGCAACGGT-1	Future spinal cord
ACTGCTCAGCAATATG-1	Distal extraembryonic ectoderm
ACTGCTCAGTCTCGGC-1	Amnion mesoderm early
ACTGCTCGTCCAGTGC-1	Primitive blood late
ACTGCTCGTTGGAGGT-1	Primitive blood late
ACTGCTCTCTTCAACT-1	Visceral endoderm late
ACTGCTCTCTTCGAGA-1	Primitive blood late
ACTGTCCAGAACAACT-1	Visceral endoderm late
ACTGTCCCAGCTCGAC-1	Visceral endoderm late
ACTGTCCGTCGCCATG-1	Gut endoderm
ACTGTCCGTGAACCTT-1	Posterior lateral plate mesoderm
ACTTACTCACATGACT-1	Visceral endoderm late
ACTTACTCACGGCGTT-1	Visceral endoderm late
ACTTACTTCGGAAACG-1	Visceral endoderm late
ACTTACTTCTGCCAGG-1	Visceral endoderm late
ACTTGTTCACCTCGTT-1	Primitive blood late
ACTTGTTTCAACACGT-1	Primitive blood late
ACTTGTTTCACGACTA-1	Primitive blood late
ACTTTCAAGCGTGTCC-1	Amnion mesoderm early
ACTTTCAAGGACACCA-1	Somites
ACTTTCAGTGAGTATA-1	Primitive blood late
ACTTTCATCACCGGGT-1	Primitive blood late
AGAATAGCAAGCGCTC-1	Visceral endoderm early
AGAATAGCAATCTGCA-1	Visceral endoderm late
AGAATAGCACAAGTAA-1	Visceral endoderm late
AGAATAGCACCACCAG-1	Primitive blood late
AGAATAGGTGCCTGCA-1	Visceral endoderm late
AGAATAGGTGCGAAAC-1	Angioblasts
AGAATAGTCGAATGCT-1	Visceral endoderm late
AGAATAGTCTAACTGG-1	Primitive blood late
AGACGTTAGGGCATGT-1	Primitive blood late
AGACGTTCAAGAGTCG-1	Angioblasts
AGACGTTCACTGCCAG-1	Future spinal cord
AGACGTTCATGACATC-1	Visceral endoderm early
AGACGTTCATGCCTAA-1	Future spinal cord
AGACGTTCATTTGCTT-1	Primitive blood late
AGACGTTGTAAGTTCC-1	Fore/midbrain
AGACGTTGTACGCACC-1	Primitive blood late
AGACGTTGTTGGGACA-1	Amnion mesoderm early
AGACGTTTCGCAAACT-1	Primitive blood late
AGAGCGACAGATCCAT-1	Visceral endoderm late
AGAGCGACAGGATTGG-1	Visceral endoderm early
AGAGCGATCGTCTGCT-1	Primitive blood late
AGAGCTTAGAAACCGC-1	Future spinal cord
AGAGCTTAGATGCCTT-1	Visceral endoderm late
AGAGCTTCACATAACC-1	Pharyngeal arch mesoderm
AGAGTGGAGCTGATAA-1	Primitive blood late
AGAGTGGAGGAATTAC-1	Visceral endoderm late
AGAGTGGAGTTAAGTG-1	Visceral endoderm early
AGAGTGGCAAAGCAAT-1	Primitive blood early
AGAGTGGCAAGTAATG-1	Distal extraembryonic ectoderm
AGAGTGGCATCGTCGG-1	Primitive blood late
AGAGTGGCATTGGGCC-1	Angioblasts
AGAGTGGGTATAGGGC-1	Visceral endoderm late
AGAGTGGGTCTGCCAG-1	Neural crest
AGAGTGGTCATCGATG-1	Primitive blood late
AGAGTGGTCTTAGCCC-1	Visceral endoderm late
AGATCTGAGGCCCTTG-1	Future spinal cord
AGATCTGAGTGGGATC-1	Visceral endoderm late
AGATCTGTCCGCGGTA-1	Amnion mesoderm early
AGATCTGTCCTTTCTC-1	Primitive blood late
AGATTGCCATACTACG-1	Visceral endoderm late
AGATTGCTCGGAGGTA-1	Visceral endoderm late
AGATTGCTCTCTTGAT-1	Amnion mesoderm late
AGCAGCCCAAACTGCT-1	Primitive blood late
AGCAGCCCAATCGGTT-1	Parietal endoderm
AGCAGCCCACATGTGT-1	Future spinal cord
AGCAGCCCATGGTAGG-1	Similar to neural crest
AGCAGCCGTCTGGTCG-1	Primitive blood late
AGCAGCCTCTGTTGAG-1	Primitive blood late
AGCATACAGTCGAGTG-1	Parietal endoderm
AGCATACGTCTCCATC-1	Primitive blood late
AGCCTAAAGAGGTTGC-1	Preplacodal ectoderm
AGCCTAAAGTTCGCAT-1	Primitive blood late
AGCCTAAGTTGGTGGA-1	Primitive blood late
AGCCTAATCTTGCCGT-1	Primitive blood late
AGCGGTCAGTACGACG-1	Visceral endoderm late
AGCGGTCTCCTTTACA-1	Visceral endoderm late
AGCGTATAGACGCAAC-1	Primitive blood late
AGCGTATAGTCGTACT-1	Visceral endoderm late
AGCGTATCAAAGCGGT-1	Visceral endoderm late
AGCGTATCATCTGGTA-1	Visceral endoderm late
AGCGTATGTCATTAGC-1	Visceral endoderm late
AGCGTCGGTATAGGGC-1	Gut endoderm
AGCGTCGGTCTAACGT-1	Visceral endoderm late
AGCGTCGTCTATCCCG-1	Visceral endoderm late
AGCTCCTAGAGTCTGG-1	Visceral endoderm late
AGCTCCTTCCAAACTG-1	Distal extraembryonic ectoderm
AGCTCTCGTGAGTATA-1	Primitive blood late
AGCTTGAAGCAGGCTA-1	Trophoblast stem cells
AGCTTGACAATCTACG-1	Primitive blood late
AGCTTGATCAGGTTCA-1	Primitive blood late
AGCTTGATCTGTGCAA-1	Visceral endoderm late
AGGCCACCACATAACC-1	Visceral endoderm late
AGGCCACCACTACAGT-1	Visceral endoderm late
AGGCCACGTGTTTGGT-1	Visceral endoderm late
AGGCCACGTTCCGTCT-1	Primitive blood early
AGGCCACGTTGCGCAC-1	Primitive blood late
AGGCCACTCGGAGCAA-1	Visceral endoderm late
AGGCCACTCTCCAGGG-1	Hematopoietic/endothelial progenitors
AGGCCACTCTTGACGA-1	Primitive blood late
AGGCCGTAGGCGCTCT-1	Angioblasts
AGGCCGTAGTAAGTAC-1	Visceral endoderm late
AGGCCGTAGTGCAAGC-1	Visceral endoderm late
AGGCCGTGTCTAAACC-1	Visceral endoderm late
AGGCCGTTCAGCACAT-1	Neuromesodermal progenitor late
AGGCCGTTCATTCACT-1	Primitive blood late
AGGCCGTTCGCTTAGA-1	Amnion mesoderm early
AGGGAGTAGACTTGAA-1	Visceral endoderm late
AGGGAGTGTAGGCTGA-1	Visceral endoderm late
AGGGAGTGTTAAAGAC-1	Visceral endoderm late
AGGGAGTTCCGTCAAA-1	Visceral endoderm late
AGGGATGCAAGCCGCT-1	Visceral endoderm late
AGGGATGCATTCTCAT-1	Angioblasts
AGGGATGGTAAGTAGT-1	Preplacodal ectoderm
AGGGATGTCGTTGCCT-1	Primitive blood late
AGGGTGACAATCCGAT-1	Primitive blood late
AGGGTGAGTTACGTCA-1	Visceral endoderm late
AGGGTGATCAATAAGG-1	Future spinal cord
AGGGTGATCGGATGTT-1	Primitive blood late
AGGTCATCAATGGACG-1	Visceral endoderm late
AGGTCATTCCAAGTAC-1	Primitive blood late
AGGTCATTCCACGCAG-1	Visceral endoderm late
AGGTCATTCCGCTGTT-1	Primitive blood late
AGGTCATTCGCCAGCA-1	Future spinal cord
AGGTCATTCGGTTCGG-1	Visceral endoderm late
AGGTCCGAGATGCGAC-1	Primitive blood late
AGGTCCGAGCGATAGC-1	Future spinal cord
AGGTCCGGTCCGTGAC-1	Angioblasts
AGGTCCGGTTGCGCAC-1	Visceral endoderm late
AGGTCCGTCCTCATTA-1	Primitive blood late
AGTAGTCAGCACAGGT-1	Angioblasts
AGTAGTCAGCTGCCCA-1	Primitive blood late
AGTAGTCAGGCGACAT-1	Visceral endoderm late
AGTAGTCAGTGGGCTA-1	Primitive blood late
AGTAGTCAGTGTACCT-1	Visceral endoderm late
AGTAGTCCAAGGTTTC-1	Gut endoderm
AGTAGTCCAGCTGCAC-1	Visceral endoderm late
AGTAGTCGTTCCACGG-1	Visceral endoderm late
AGTCTTTCATCGATTG-1	Pharyngeal arch mesoderm
AGTCTTTGTAGAAAGG-1	Primitive blood late
AGTCTTTGTATAGGTA-1	Gut endoderm
AGTCTTTGTGGCCCTA-1	Amnion mesoderm early
AGTGAGGCAATGGATA-1	Primitive blood late
AGTGAGGCAGGGTATG-1	Primitive blood late
AGTGAGGCAGTATAAG-1	Similar to neural crest
AGTGAGGGTAATCGTC-1	Visceral endoderm late
AGTGGGAGTCTGCAAT-1	Angioblasts
AGTGGGATCCTTGACC-1	Visceral endoderm late
AGTGTCAGTAGATTAG-1	Visceral endoderm late
AGTGTCATCTCGTTTA-1	Visceral endoderm late
AGTTGGTAGGGTGTTG-1	Primitive blood late
AGTTGGTAGTCGAGTG-1	Primitive blood late
AGTTGGTTCCACGAAT-1	Visceral endoderm late
ATAACGCTCATGTGGT-1	Somites
ATAAGAGCACTGTTAG-1	Visceral endoderm late
ATAAGAGTCAGTTTGG-1	Visceral endoderm late
ATAGACCAGCGCCTCA-1	Fore/midbrain
ATAGACCAGTAGCGGT-1	Visceral endoderm late
ATAGACCAGTCGTACT-1	Visceral endoderm late
ATAGACCGTCGGCACT-1	Primitive blood late
ATCACGACAGTTCATG-1	Primitive blood late
ATCACGAGTCTAGTGT-1	Primitive blood late
ATCACGAGTTGGAGGT-1	Visceral endoderm late
ATCACGATCTCAACTT-1	Parietal endoderm
ATCATCTAGCTGCGAA-1	Primitive blood late
ATCATCTCATCCCATC-1	Secondary heart field/splanchnic lateral plate
ATCATGGAGAGTGAGA-1	Visceral endoderm late
ATCATGGAGTTGAGTA-1	Visceral endoderm late
ATCATGGCAAGTCTAC-1	Visceral endoderm late
ATCATGGCACCCTATC-1	Primitive blood late
ATCATGGGTGACCAAG-1	Visceral endoderm late
ATCATGGTCAACACCA-1	Primitive blood late
ATCCACCAGAGTCTGG-1	Visceral endoderm late
ATCCACCTCTGCAAGT-1	Neuromesodermal progenitor late
ATCCACCTCTTATCTG-1	Primitive blood late
ATCCGAACAGGGTTAG-1	Visceral endoderm late
ATCCGAACAGTTTACG-1	Visceral endoderm late
ATCCGAACATCGATTG-1	Primitive blood late
ATCCGAAGTTTGCATG-1	Primitive blood late
ATCCGAATCACAACGT-1	Visceral endoderm late
ATCGAGTGTCCCGACA-1	Distal extraembryonic ectoderm
ATCGAGTTCGCTAGCG-1	Primitive blood late
ATCGAGTTCGTTGACA-1	Allantois
ATCTACTAGTGGTAAT-1	Primitive blood progenitors
ATCTACTCATCACGTA-1	Differentiated trophoblasts
ATCTACTGTAGGGACT-1	Posterior lateral plate mesoderm
ATCTACTTCGGAGGTA-1	Primitive blood late
ATCTGCCAGCTGTTCA-1	Visceral endoderm late
ATCTGCCAGGGTGTGT-1	Primitive heart tube
ATCTGCCCATGGTCTA-1	Gut endoderm
ATCTGCCGTAGCGTCC-1	Preplacodal ectoderm
ATCTGCCTCATCTGCC-1	Primitive heart tube
ATGAGGGTCGGTCTAA-1	Presomitic mesoderm
ATGCGATCATAGAAAC-1	Visceral endoderm late
ATGCGATGTACTTAGC-1	Gut endoderm
ATGCGATGTGCACGAA-1	Visceral endoderm late
ATGCGATTCAAAGTAG-1	Visceral endoderm late
ATGCGATTCCAAATGC-1	Visceral endoderm late
ATGCGATTCTCAAGTG-1	Pharyngeal arch mesoderm
ATGCGATTCTCCGGTT-1	Primitive blood late
ATGGGAGAGATGTCGG-1	Visceral endoderm late
ATGGGAGCATTGTGCA-1	Visceral endoderm late
ATGGGAGGTAGCGTGA-1	Visceral endoderm late
ATGGGAGTCATGGTCA-1	Visceral endoderm late
ATGTGTGAGCGTTTAC-1	Amnion mesoderm early
ATGTGTGAGTGGCACA-1	Angioblasts
ATGTGTGCACGAGGTA-1	Preplacodal ectoderm
ATGTGTGCAGCGATCC-1	Similar to neural crest
ATGTGTGGTTCAGACT-1	Amnion mesoderm early
ATGTGTGTCAAAGTAG-1	Amnion mesoderm early
ATTACTCAGCAATCTC-1	Angioblasts
ATTACTCCAAAGTCAA-1	Parietal endoderm
ATTACTCCAACCGCCA-1	Primitive blood late
ATTACTCCAATTGCTG-1	Amnion mesoderm early
ATTACTCCACACATGT-1	Visceral endoderm early
ATTACTCGTTAAGGGC-1	Angioblasts
ATTACTCTCTAGCACA-1	Future spinal cord
ATTATCCAGTGGGATC-1	Visceral endoderm late
ATTATCCCAGACGCAA-1	Angioblasts
ATTATCCCAGTCCTTC-1	Preplacodal ectoderm
ATTATCCTCGCGTTTC-1	Visceral endoderm late
ATTCTACAGTCTCCTC-1	Primitive blood late
ATTCTACGTCAGATAA-1	Primitive blood late
ATTCTACGTCTAGTGT-1	Visceral endoderm late
ATTCTACGTGTAAGTA-1	Secondary heart field/splanchnic lateral plate
ATTCTACTCAGAGGTG-1	Primitive blood late
ATTCTACTCTTCGGTC-1	Visceral endoderm late
ATTGGACCACCAGCAC-1	Primitive blood late
ATTGGACCATGGTCTA-1	Visceral endoderm late
ATTGGACTCCCATTAT-1	Primitive blood late
ATTGGACTCGAACTGT-1	Primitive blood progenitors
ATTGGTGAGACCTAGG-1	Visceral endoderm late
ATTGGTGAGCGAGAAA-1	Angioblasts
ATTGGTGAGCGTAATA-1	Parietal endoderm
ATTGGTGCACATCTTT-1	Similar to neural crest
ATTGGTGCAGCGAACA-1	Surface ectoderm
ATTTCTGGTCACAAGG-1	Visceral endoderm late
ATTTCTGGTGTCGCTG-1	Visceral endoderm late
ATTTCTGGTTCATGGT-1	Presomitic mesoderm
ATTTCTGTCAGTGCAT-1	Neural crest
CAACCAACACGGTAGA-1	Visceral endoderm late
CAACCAAGTACCGTTA-1	Visceral endoderm late
CAACCAAGTTCGAATC-1	Primitive blood late
CAACCTCAGATGTGTA-1	Visceral endoderm late
CAACCTCAGGAACTGC-1	Visceral endoderm late
CAACCTCCACCTCGTT-1	Primitive blood late
CAACCTCCATTACGAC-1	Primitive blood late
CAACTAGAGCCGCCTA-1	Primitive blood late
CAACTAGCAATGACCT-1	Somites
CAACTAGGTGGCAAAC-1	Amnion mesoderm early
CAACTAGTCCGTCAAA-1	Visceral endoderm early
CAAGAAAGTAAGGATT-1	Visceral endoderm late
CAAGATCAGATAGCAT-1	Future spinal cord
CAAGATCCATAGACTC-1	Visceral endoderm early
CAAGATCGTATTACCG-1	Visceral endoderm late
CAAGGCCGTAACGTTC-1	Primitive blood progenitors
CAAGGCCGTGCCTTGG-1	Angioblasts
CAAGGCCGTTCGGCAC-1	Visceral endoderm late
CAAGGCCTCCGGGTGT-1	Amnion mesoderm early
CAAGTTGCATGGTTGT-1	Primitive blood progenitors
CACAAACGTCAAGCGA-1	Angioblasts
CACAAACGTGGCTCCA-1	Primitive blood late
CACAAACGTTCTGAAC-1	Preplacodal ectoderm
CACAAACTCAAGCCTA-1	Visceral endoderm late
CACAAACTCCAGGGCT-1	Primitive blood late
CACAAACTCTGCAAGT-1	Neural crest
CACACAACATGGTCAT-1	Preplacodal ectoderm
CACACAAGTTCATGGT-1	Parietal endoderm
CACACAAGTTGGAGGT-1	Presomitic mesoderm
CACACAATCGTGGACC-1	Posterior lateral plate mesoderm
CACACCTAGAAACCAT-1	Visceral endoderm late
CACACCTCATCAGTAC-1	Visceral endoderm late
CACACCTGTAAACCTC-1	Primitive blood late
CACACCTTCCCGGATG-1	Gut endoderm
CACACTCGTCCGCTGA-1	Primitive blood late
CACACTCTCCTTTCTC-1	Visceral endoderm late
CACAGGCAGCGGCTTC-1	Hematopoietic/endothelial progenitors
CACAGGCAGGGCTCTC-1	Visceral endoderm late
CACAGGCCACGACGAA-1	Primitive blood early
CACAGTAAGGCTAGAC-1	Primitive blood late
CACAGTAAGTGGGATC-1	Visceral endoderm late
CACAGTACACTCGACG-1	Presomitic mesoderm
CACAGTAGTGGCGAAT-1	Somites
CACAGTATCAACCATG-1	Primitive heart tube
CACAGTATCTCAAACG-1	Visceral endoderm late
CACATAGCATACTCTT-1	Visceral endoderm late
CACATAGGTAAATGTG-1	Primitive blood late
CACATAGGTTACGCGC-1	Primitive blood late
CACATAGTCACAACGT-1	Visceral endoderm late
CACATAGTCGCCATAA-1	Primitive blood late
CACATTTAGCGTGAAC-1	Primitive blood late
CACATTTCAATCGGTT-1	Primitive blood late
CACATTTCACTCAGGC-1	Visceral endoderm late
CACATTTGTACAGCAG-1	Visceral endoderm late
CACATTTGTCTAACGT-1	Visceral endoderm late
CACATTTTCAGCGACC-1	Visceral endoderm late
CACCACTGTACGCACC-1	Visceral endoderm early
CACCACTGTTGATTGC-1	Visceral endoderm late
CACCACTTCGTTACAG-1	Somites
CACCACTTCTCCGGTT-1	Gut endoderm
CACCAGGAGCATCATC-1	Preplacodal ectoderm
CACCAGGCACGAAATA-1	Primitive blood late
CACCAGGTCCCAGGTG-1	Visceral endoderm late
CACCAGGTCCTAGAAC-1	Visceral endoderm late
CACCAGGTCGCAGGCT-1	Primitive blood late
CACCAGGTCTGCTTGC-1	Visceral endoderm late
CACCTTGAGCTAAGAT-1	Primitive blood late
CACCTTGCACTGAAGG-1	Secondary heart field/splanchnic lateral plate
CACCTTGCAGCCTTTC-1	Visceral endoderm late
CACCTTGTCGCGATCG-1	Visceral endoderm late
CACTCCAAGCTGCAAG-1	Allantois
CACTCCAAGTTCGCAT-1	Neuromesodermal progenitor late
CACTCCACACTTCTGC-1	Gut endoderm
CACTCCATCGGTGTCG-1	Visceral endoderm late
CAGAATCAGTGATCGG-1	Primitive blood late
CAGAATCCACGGTAAG-1	Angioblasts
CAGAATCTCGCGATCG-1	Primitive blood late
CAGAGAGAGTCCCACG-1	Gut endoderm
CAGAGAGCAATCAGAA-1	Posterior lateral plate mesoderm
CAGAGAGCAGACGCCT-1	Somites
CAGAGAGCAGCCTGTG-1	Visceral endoderm late
CAGAGAGGTTAGTGGG-1	Angioblasts
CAGAGAGTCACCGGGT-1	Visceral endoderm early
CAGAGAGTCTATGTGG-1	Trophoblast stem cells
CAGATCAAGATGCCAG-1	Primitive blood late
CAGATCACACACAGAG-1	Preplacodal ectoderm
CAGATCATCCTTTCGG-1	Visceral endoderm late
CAGATCATCGTATCAG-1	Visceral endoderm late
CAGCAGCTCTCGGACG-1	Primitive blood late
CAGCATAAGATGAGAG-1	Amnion mesoderm early
CAGCATAAGCGTAATA-1	Visceral endoderm early
CAGCATAAGTGGGTTG-1	Visceral endoderm late
CAGCATACACTATCTT-1	Angioblasts
CAGCATAGTAGCGTAG-1	Visceral endoderm late
CAGCATAGTGCGATAG-1	Visceral endoderm late
CAGCCGAAGCGGATCA-1	Trophoblast stem cells
CAGCCGACAATGGATA-1	Somites
CAGCCGACATGCCTTC-1	Primitive blood early
CAGCCGAGTCATACTG-1	Visceral endoderm late
CAGCCGATCAGTTTGG-1	Future spinal cord
CAGCCGATCCCTAATT-1	Visceral endoderm late
CAGCCGATCCGGGTGT-1	Visceral endoderm late
CAGCCGATCGAATCCA-1	Visceral endoderm late
CAGCGACAGATCCGAG-1	Allantois
CAGCGACCACGTGAGA-1	Angioblasts
CAGCGACTCGCCAGCA-1	Primitive blood late
CAGCGACTCGGTTCGG-1	Similar to neural crest
CAGCTAACAAGTTAAG-1	Visceral endoderm early
CAGCTAAGTAGAGCTG-1	Visceral endoderm late
CAGCTGGCATGGATGG-1	Primitive blood late
CAGCTGGCATTACGAC-1	Visceral endoderm late
CAGCTGGGTCCTAGCG-1	Primitive blood late
CAGCTGGTCCAAGCCG-1	Presomitic mesoderm
CAGCTGGTCGTTACGA-1	Trophoblast stem cells
CAGGTGCAGTGCCAGA-1	Visceral endoderm late
CAGGTGCCATACGCTA-1	Neural ectoderm posterior
CAGGTGCCATTGCGGC-1	Primitive blood late
CAGGTGCGTCAACATC-1	Primitive blood late
CAGGTGCGTGAGGCTA-1	Primitive blood late
CAGGTGCTCTACCAGA-1	Similar to neural crest
CAGGTGCTCTCCCTGA-1	Visceral endoderm late
CAGTAACAGCTCTCGG-1	Hematopoietic/endothelial progenitors
CAGTAACGTGCTAGCC-1	Somites
CAGTAACTCCAAGCCG-1	Visceral endoderm late
CAGTCCTCATGATCCA-1	Angioblasts
CAGTCCTGTAAGTGTA-1	Primitive blood late
CAGTCCTTCACGAAGG-1	Visceral endoderm late
CAGTCCTTCATAACCG-1	Secondary heart field/splanchnic lateral plate
CAGTCCTTCCAAACTG-1	Distal extraembryonic ectoderm
CATATGGAGACTCGGA-1	Primitive blood late
CATATGGAGCTAACAA-1	Visceral endoderm late
CATATGGAGCTCCCAG-1	Differentiated trophoblasts
CATATGGGTTCGCGAC-1	Visceral endoderm early
CATATGGTCTTGTTTG-1	Parietal endoderm
CATATTCAGCTAGCCC-1	Visceral endoderm late
CATATTCAGGACACCA-1	Angioblasts
CATATTCCACAAGTAA-1	Visceral endoderm late
CATATTCGTGTAACGG-1	Primitive blood late
CATATTCGTTCATGGT-1	Primitive blood late
CATATTCGTTCCCTTG-1	Angioblasts
CATATTCTCAGTGCAT-1	Visceral endoderm early
CATCAAGAGCGTTGCC-1	Somites
CATCAAGCAGCTATTG-1	Neuromesodermal progenitor late
CATCAAGGTGTCCTCT-1	Visceral endoderm late
CATCAAGTCACAACGT-1	Visceral endoderm late
CATCAAGTCCAACCAA-1	Visceral endoderm late
CATCAGACAACACGCC-1	Parietal endoderm
CATCAGACAGGTGGAT-1	Allantois
CATCAGAGTGTGACCC-1	Primitive blood late
CATCAGATCCAACCAA-1	Gut endoderm
CATCCACAGACATAAC-1	Presomitic mesoderm
CATCCACAGTGTTTGC-1	Primitive blood late
CATCCACCAAGGCTCC-1	Somites
CATCCACCACATCCAA-1	Primitive blood late
CATCCACCAGTTCCCT-1	Visceral endoderm late
CATCCACTCAAAGACA-1	Visceral endoderm late
CATCCACTCAACGGCC-1	Primitive blood late
CATCCACTCGCCGTGA-1	Angioblasts
CATCCACTCTCGGACG-1	Visceral endoderm late
CATCCACTCTCTAAGG-1	Parietal endoderm
CATCGAAAGATGCCTT-1	Visceral endoderm late
CATCGAACAGTTAACC-1	Visceral endoderm late
CATCGAAGTACTCAAC-1	Differentiated trophoblasts
CATCGAAGTCCCTTGT-1	Visceral endoderm late
CATCGAATCGCCTGAG-1	Primitive blood late
CATCGAATCTGACCTC-1	Amnion mesoderm early
CATCGGGAGACTCGGA-1	Amnion mesoderm early
CATGACAAGGACACCA-1	Visceral endoderm late
CATGACACAGTCAGAG-1	Hematopoietic/endothelial progenitors
CATGACAGTGTAAGTA-1	Primitive blood late
CATGACAGTTCTGGTA-1	Allantois
CATGACATCCTTGGTC-1	Secondary heart field/splanchnic lateral plate
CATGCCTAGATATACG-1	Neural ectoderm posterior
CATGCCTAGCGACGTA-1	Primitive blood late
CATGCCTGTCAAACTC-1	Somites
CATGGCGCAGCATACT-1	Visceral endoderm late
CATGGCGGTTCAGACT-1	Parietal endoderm
CATTATCAGAATGTTG-1	Future spinal cord
CATTATCCAGCAGTTT-1	Future spinal cord
CATTATCCAGGTCCAC-1	Primitive blood late
CATTCGCAGGACTGGT-1	Visceral endoderm late
CATTCGCGTCCAACTA-1	Similar to neural crest
CATTCGCTCGCGGATC-1	Visceral endoderm late
CATTCGCTCGTGGACC-1	Amnion mesoderm early
CCAATCCCAATAACGA-1	Primitive blood late
CCAATCCCACGAGAGT-1	Visceral endoderm late
CCAATCCCACTGTCGG-1	Visceral endoderm early
CCACCTAAGAGAACAG-1	Secondary heart field/splanchnic lateral plate
CCACCTACACATCTTT-1	Visceral endoderm late
CCACGGAAGAAGGGTA-1	Visceral endoderm late
CCACGGAAGCCCAGCT-1	Visceral endoderm early
CCACGGAAGCTCCTCT-1	Distal extraembryonic ectoderm
CCACGGACACTAAGTC-1	Primitive blood late
CCACGGAGTCCGTCAG-1	Primitive blood late
CCACTACAGAATCTCC-1	Trophoblast stem cells
CCACTACCATTGGCGC-1	Somites
CCAGCGATCGGCCGAT-1	Presomitic mesoderm
CCATGTCAGGTTCCTA-1	Primitive blood early
CCATGTCGTTCAGGCC-1	Visceral endoderm late
CCATGTCGTTGAGTTC-1	Visceral endoderm late
CCATGTCTCGTTACGA-1	Primitive heart tube
CCATGTCTCTGCGTAA-1	Primitive blood late
CCATTCGAGGCTAGCA-1	Visceral endoderm late
CCATTCGAGTGAAGAG-1	Amnion mesoderm early
CCATTCGTCCGTACAA-1	Visceral endoderm late
CCATTCGTCGAATCCA-1	Primitive blood late
CCATTCGTCGCGATCG-1	Visceral endoderm late
CCCAATCAGATGGCGT-1	Primitive blood late
CCCAATCCATGCCACG-1	Visceral endoderm late
CCCAATCGTAGCCTCG-1	Angioblasts
CCCAATCGTCTGGAGA-1	Posterior lateral plate mesoderm
CCCAATCGTTTGACTG-1	Angioblasts
CCCAGTTAGGACATTA-1	Amnion mesoderm early
CCCAGTTCACGAAATA-1	Angioblasts
CCCAGTTGTAGGACAC-1	Visceral endoderm late
CCCAGTTTCCCGGATG-1	Visceral endoderm late
CCCAGTTTCGCCATAA-1	Surface ectoderm
CCCAGTTTCTTGCCGT-1	Primitive blood late
CCCATACAGGATGCGT-1	Angioblasts
CCCATACCACCGCTAG-1	Visceral endoderm late
CCCATACCAGCTTAAC-1	Visceral endoderm late
CCCTCCTAGGGTCTCC-1	Secondary heart field/splanchnic lateral plate
CCCTCCTTCCATGAGT-1	Visceral endoderm late
CCGGGATAGATATGCA-1	Visceral endoderm late
CCGGGATCACCAGGCT-1	Posterior lateral plate mesoderm
CCGGGATCATCTATGG-1	Preplacodal ectoderm
CCGGGATTCCAATGGT-1	Primitive blood late
CCGGTAGGTCGGATCC-1	Primitive blood late
CCGGTAGTCCTAAGTG-1	Angioblasts
CCGTACTAGCTGGAAC-1	Primitive blood late
CCGTACTAGTTGTCGT-1	Primitive blood late
CCGTACTCAACCGCCA-1	Visceral endoderm late
CCGTACTTCAATCACG-1	Visceral endoderm late
CCGTGGAAGGTGATTA-1	Amnion mesoderm late
CCGTGGAAGTTGTCGT-1	Parietal endoderm
CCGTTCAAGAAGGTGA-1	Future spinal cord
CCGTTCACAGACTCGC-1	Primitive blood late
CCGTTCAGTCCTCCAT-1	Preplacodal ectoderm
CCGTTCATCAGCTCGG-1	Visceral endoderm early
CCTAAAGCATAGGATA-1	Visceral endoderm late
CCTAAAGGTCGTCTTC-1	Visceral endoderm late
CCTACACAGCCGGTAA-1	Amnion mesoderm late
CCTACACAGCGCCTTG-1	Visceral endoderm late
CCTACACAGTGACATA-1	Amnion mesoderm early
CCTACACCAACACGCC-1	Pharyngeal arch mesoderm
CCTACACCACCTCGGA-1	Visceral endoderm early
CCTACACGTCCGTTAA-1	Visceral endoderm late
CCTACACGTTTGGCGC-1	Primitive blood late
CCTACACTCTCCAGGG-1	Primitive blood late
CCTACACTCTCCTATA-1	Neuromesodermal progenitor late
CCTACCACAGTAAGAT-1	Visceral endoderm late
CCTAGCTCACCTGGTG-1	Primitive blood late
CCTAGCTGTCAGTGGA-1	Posterior lateral plate mesoderm
CCTAGCTTCCATGAGT-1	Primitive blood late
CCTATTAAGAGTGAGA-1	Primitive blood late
CCTATTAAGCAGCGTA-1	Angioblasts
CCTATTATCGTTACAG-1	Angioblasts
CCTCAGTGTAGCAAAT-1	Similar to neural crest
CCTCAGTGTGGTCTCG-1	Primitive blood late
CCTCAGTTCGGCGGTT-1	Visceral endoderm late
CCTCTGAAGATGAGAG-1	Primitive blood late
CCTCTGAAGTAACCCT-1	Primitive blood late
CCTCTGAGTATAGGTA-1	Visceral endoderm early
CCTTACGAGTCACGCC-1	Primitive blood late
CCTTACGCAGGTGGAT-1	Visceral endoderm late
CCTTACGGTAGAAGGA-1	Amnion mesoderm early
CCTTACGTCTTAGCCC-1	Visceral endoderm late
CCTTCCCCACCTCGTT-1	Primitive blood late
CCTTCCCTCCCTAATT-1	Primitive blood late
CCTTCGAGTACGACCC-1	Visceral endoderm late
CCTTCGAGTGGTGTAG-1	Visceral endoderm late
CCTTTCTAGGGTCTCC-1	Primitive heart tube
CCTTTCTGTATAGTAG-1	Primitive blood late
CGAACATAGCTAGTCT-1	Visceral endoderm late
CGAACATAGGCATGGT-1	Primitive blood late
CGAACATCAACGATCT-1	Visceral endoderm late
CGAACATCAGTGGGAT-1	Primitive blood late
CGAATGTCATAGTAAG-1	Primitive blood late
CGAATGTCATCAGTAC-1	Parietal endoderm
CGAATGTTCCAAATGC-1	Gut endoderm
CGAATGTTCGTCCAGG-1	Posterior lateral plate mesoderm
CGACCTTCATCTGGTA-1	Gut endoderm
CGACCTTGTCAATGTC-1	Hematopoietic/endothelial progenitors
CGACCTTTCAGTTCGA-1	Visceral endoderm late
CGACCTTTCCGCAGTG-1	Primitive blood late
CGACTTCAGATATACG-1	Primitive blood late
CGACTTCGTCTGCGGT-1	Visceral endoderm late
CGACTTCTCCAAACAC-1	Amnion mesoderm early
CGACTTCTCGCTGATA-1	Similar to neural crest
CGAGAAGAGCCACGTC-1	Visceral endoderm late
CGAGAAGCACAAGTAA-1	Visceral endoderm late
CGAGAAGGTCGAATCT-1	Visceral endoderm late
CGAGCACAGAGTGAGA-1	Posterior lateral plate mesoderm
CGAGCACAGGTGATAT-1	Primitive blood late
CGAGCACGTCATCCCT-1	Visceral endoderm early
CGAGCACGTTACCGAT-1	Primitive blood late
CGAGCCAAGCTGTTCA-1	Similar to neural crest
CGAGCCACAGTCAGAG-1	Allantois
CGAGCCACAGTCGTGC-1	Parietal endoderm
CGAGCCAGTACCCAAT-1	Visceral endoderm late
CGAGCCAGTTCTCATT-1	Neuromesodermal progenitor late
CGAGCCATCGAACGGA-1	Primitive blood late
CGATCGGCAAGGACAC-1	Visceral endoderm late
CGATCGGCAATTCCTT-1	Primitive blood late
CGATCGGTCACAGGCC-1	Visceral endoderm late
CGATGGCAGGACTGGT-1	Distal extraembryonic ectoderm
CGATGGCGTACATGTC-1	Visceral endoderm late
CGATGGCTCCTTTCTC-1	Parietal endoderm
CGATGGCTCTTTAGTC-1	Visceral endoderm late
CGATGTAAGGAGTTTA-1	Amnion mesoderm early
CGATTGAAGAGAACAG-1	Preplacodal ectoderm
CGATTGAAGGCAGGTT-1	Visceral endoderm late
CGATTGAAGTAACCCT-1	Amnion mesoderm early
CGATTGACAAGGGTCA-1	Gut endoderm
CGATTGACACCGAATT-1	Visceral endoderm late
CGATTGACACGTCTCT-1	Visceral endoderm late
CGATTGACAGTGGGAT-1	Primitive blood late
CGATTGATCAGTTTGG-1	Somites
CGCCAAGAGGCATGTG-1	Primitive blood late
CGCGGTAAGACGCACA-1	Primitive blood late
CGCGGTAAGAGCTGCA-1	Primitive blood late
CGCGGTACATAGACTC-1	Visceral endoderm late
CGCGTTTAGCGTCTAT-1	Visceral endoderm late
CGCGTTTCAAATCCGT-1	Primitive blood late
CGCGTTTCAGCTTAAC-1	Visceral endoderm late
CGCGTTTCATACCATG-1	Visceral endoderm late
CGCGTTTGTAAGTGTA-1	Angioblasts
CGCGTTTGTCTGCGGT-1	Somites
CGCGTTTTCAACTCTT-1	Parietal endoderm
CGCTATCAGACAGACC-1	Primitive blood late
CGCTATCAGCAATCTC-1	Primitive blood late
CGCTATCCAGACGCAA-1	Somites
CGCTATCTCAGTACGT-1	Visceral endoderm late
CGCTGGAAGTTTGCGT-1	Primitive blood early
CGCTGGACAGCTCCGA-1	Amnion mesoderm early
CGCTTCAAGCAAATCA-1	Visceral endoderm late
CGCTTCACAGTCGTGC-1	Visceral endoderm late
CGCTTCATCATACGGT-1	Primitive blood late
CGCTTCATCTGCTGCT-1	Visceral endoderm late
CGGACACAGCTAGTTC-1	Visceral endoderm late
CGGACACCACACCGAC-1	Future spinal cord
CGGACACCACCCAGTG-1	Primitive blood late
CGGACACGTACAGTGG-1	Visceral endoderm late
CGGACACGTCCCGACA-1	Visceral endoderm late
CGGACACGTGAGTATA-1	Visceral endoderm late
CGGACGTGTAGCTAAA-1	Fore/midbrain
CGGACGTGTGATGCCC-1	Visceral endoderm late
CGGACTGCAAACGTGG-1	Visceral endoderm late
CGGACTGGTCTGGAGA-1	Primitive blood late
CGGACTGTCCAGTATG-1	Neural crest
CGGACTGTCGGACAAG-1	Secondary heart field/splanchnic lateral plate
CGGAGCTAGAAGAAGC-1	Trophoblast stem cells
CGGAGCTAGACCACGA-1	Visceral endoderm late
CGGAGCTAGCGCTCCA-1	Visceral endoderm late
CGGAGCTCAAGTCATC-1	Visceral endoderm late
CGGAGCTCACTGTTAG-1	Primitive blood early
CGGAGCTCAGGAACGT-1	Primitive blood late
CGGAGCTGTACTCTCC-1	Fore/midbrain
CGGAGCTTCGGGAGTA-1	Visceral endoderm late
CGGAGCTTCTGCCAGG-1	Similar to neural crest
CGGAGTCGTCAATGTC-1	Visceral endoderm late
CGGAGTCGTCATATCG-1	Visceral endoderm late
CGGAGTCTCCGAAGAG-1	Primitive blood late
CGGAGTCTCCGCATAA-1	Amnion mesoderm early
CGGCTAGCATGCTGGC-1	Primitive blood late
CGGCTAGTCCTTGACC-1	Visceral endoderm early
CGGGTCACAGATCCAT-1	Neural crest
CGGGTCAGTATAATGG-1	Parietal endoderm
CGGGTCAGTGAAGGCT-1	Primitive blood late
CGGGTCATCCCACTTG-1	Angioblasts
CGGGTCATCGCTAGCG-1	Fore/midbrain
CGGTTAAGTACGACCC-1	Visceral endoderm late
CGTAGCGAGAACTGTA-1	Visceral endoderm late
CGTAGCGCAGCCTGTG-1	Fore/midbrain
CGTAGCGGTACAGTGG-1	Primitive blood late
CGTAGCGGTTCTGGTA-1	Trophoblast stem cells
CGTAGGCAGCTGCAAG-1	Primitive blood early
CGTAGGCTCCTAGTGA-1	Visceral endoderm late
CGTCACTAGTCAAGGC-1	Visceral endoderm late
CGTCACTCATAGTAAG-1	Amnion mesoderm early
CGTCACTCATGGTCAT-1	Angioblasts
CGTCACTTCAAACCAC-1	Future spinal cord
CGTCAGGAGAGGTAGA-1	Visceral endoderm late
CGTCAGGGTCCTCCAT-1	Parietal endoderm
CGTCCATAGACGCTTT-1	Primitive blood late
CGTCCATCATGTTGAC-1	Future spinal cord
CGTCTACCAAGCTGAG-1	Primitive blood late
CGTCTACCATCCGCGA-1	Somites
CGTCTACGTCAAACTC-1	Primitive blood late
CGTCTACGTCTACCTC-1	Visceral endoderm early
CGTCTACGTGACAAAT-1	Secondary heart field/splanchnic lateral plate
CGTCTACTCGCCAGCA-1	Primitive blood early
CGTGAGCAGAGGTAGA-1	Parietal endoderm
CGTGAGCCACCTGGTG-1	Primitive blood late
CGTGAGCGTCGAGATG-1	Trophoblast stem cells
CGTGTCTCACGTTGGC-1	Parietal endoderm
CGTGTCTCAGCTTAAC-1	Visceral endoderm late
CGTGTCTGTCCATGAT-1	Somites
CGTGTCTGTGTGCGTC-1	Differentiated trophoblasts
CGTGTCTTCAACGGCC-1	Primitive blood late
CGTGTCTTCGGACAAG-1	Visceral endoderm late
CGTGTCTTCGGCTTGG-1	Neural crest
CGTTAGAGTGGACGAT-1	Primitive blood late
CGTTAGATCGATAGAA-1	Differentiated trophoblasts
CGTTCTGAGATCCGAG-1	Primitive blood late
CGTTCTGAGGGCTCTC-1	Primitive blood progenitors
CGTTGGGGTAAGAGGA-1	Primitive blood late
CGTTGGGGTTTGTTGG-1	Primitive blood late
CTAACTTGTACAAGTA-1	Primitive blood late
CTAAGACAGAGGTTAT-1	Visceral endoderm late
CTAAGACAGTTGAGTA-1	Visceral endoderm late
CTAAGACGTCGCATCG-1	Visceral endoderm late
CTAAGACTCACAGGCC-1	Visceral endoderm late
CTAATGGAGGTGATAT-1	Visceral endoderm late
CTACACCTCCAGAGGA-1	Primitive blood late
CTACACCTCTAACGGT-1	Visceral endoderm late
CTACATTCAATGGTCT-1	Visceral endoderm late
CTACATTCAGCGTTCG-1	Visceral endoderm late
CTACATTTCGGGAGTA-1	Visceral endoderm late
CTACATTTCGGTTCGG-1	Gut endoderm
CTACCCAAGCTCCTCT-1	Gut endoderm
CTACCCAAGGCTCATT-1	Visceral endoderm late
CTACCCATCTGCTGCT-1	Distal extraembryonic ectoderm
CTACGTCTCCGTAGGC-1	Visceral endoderm late
CTAGAGTCATTCCTCG-1	Somites
CTAGAGTGTTACGCGC-1	Secondary heart field/splanchnic lateral plate
CTAGAGTGTTTGACTG-1	Visceral endoderm late
CTAGTGAAGCTCTCGG-1	Angioblasts
CTAGTGAAGTCATGCT-1	Primitive blood late
CTAGTGAAGTGCCATT-1	Visceral endoderm late
CTAGTGACACTTCGAA-1	Primitive blood late
CTAGTGAGTACGCACC-1	Visceral endoderm late
CTAGTGAGTGCATCTA-1	Primitive blood early
CTAGTGATCTGATACG-1	Visceral endoderm late
CTCACACAGAAACGAG-1	Visceral endoderm late
CTCACACAGCTGCGAA-1	Visceral endoderm late
CTCACACTCAGTTGAC-1	Differentiated trophoblasts
CTCACACTCGGATGTT-1	Somites
CTCAGAACAGCCTTGG-1	Primitive blood late
CTCAGAAGTTACTGAC-1	Angioblasts
CTCAGAATCCGAAGAG-1	Somites
CTCAGAATCCTAAGTG-1	Angioblasts
CTCATTAAGAAGGTGA-1	Visceral endoderm late
CTCATTACAATAGCAA-1	Visceral endoderm late
CTCATTACAGGTTTCA-1	Angioblasts
CTCATTACATATGAGA-1	Visceral endoderm late
CTCATTAGTCTCCCTA-1	Visceral endoderm late
CTCATTAGTGACCAAG-1	Visceral endoderm late
CTCCTAGAGCACAGGT-1	Similar to neural crest
CTCCTAGCACGGCTAC-1	Primitive blood late
CTCCTAGGTATCGCAT-1	Neuromesodermal progenitor late
CTCCTAGTCAAACCGT-1	Visceral endoderm early
CTCGAAAAGACAAGCC-1	Preplacodal ectoderm
CTCGAAATCAGCGACC-1	Primitive blood early
CTCGAGGAGGAGCGAG-1	Visceral endoderm late
CTCGAGGGTTACGGAG-1	Secondary heart field/splanchnic lateral plate
CTCGAGGTCATATCGG-1	Visceral endoderm late
CTCGAGGTCCCGGATG-1	Primitive blood late
CTCGGAGAGTTTCCTT-1	Visceral endoderm early
CTCGGAGCAAGGCTCC-1	Future spinal cord
CTCGGAGGTCCAGTTA-1	Angioblasts
CTCGGAGTCGTACGGC-1	Visceral endoderm late
CTCGGGAAGGCTCTTA-1	Primitive blood late
CTCGGGACAACTGGCC-1	Primitive blood late
CTCGGGAGTAGGAGTC-1	Visceral endoderm late
CTCGGGAGTGAAGGCT-1	Similar to neural crest
CTCGGGATCGGAAACG-1	Visceral endoderm late
CTCGTACCACCAACCG-1	Amnion mesoderm early
CTCGTACGTAAGAGAG-1	Angioblasts
CTCGTACTCCTCATTA-1	Amnion mesoderm early
CTCGTACTCTGATTCT-1	Visceral endoderm early
CTCGTCAAGCTGCCCA-1	Primitive blood late
CTCGTCAAGGGAGTAA-1	Gut endoderm
CTCGTCACAGCTGCTG-1	Primitive blood late
CTCGTCAGTACAAGTA-1	Hematopoietic/endothelial progenitors
CTCGTCATCTTGCCGT-1	Preplacodal ectoderm
CTCTAATAGATATGGT-1	Primitive heart tube
CTCTAATAGTCATCCA-1	Primitive blood early
CTCTAATAGTCCAGGA-1	Visceral endoderm late
CTCTAATAGTGATCGG-1	Visceral endoderm late
CTCTAATTCAAAGTAG-1	Primitive blood progenitors
CTCTACGAGTCCGTAT-1	Somites
CTCTACGCACACGCTG-1	Primitive blood late
CTCTACGCACAGCGTC-1	Visceral endoderm late
CTCTACGGTTGCTCCT-1	Visceral endoderm late
CTCTACGTCGTTACGA-1	Visceral endoderm late
CTCTGGTCAATGTAAG-1	Angioblasts
CTCTGGTCAGACTCGC-1	Amnion mesoderm early
CTCTGGTGTATAAACG-1	Somites
CTCTGGTTCCGAATGT-1	Visceral endoderm late
CTGAAACCATTGGCGC-1	Gut endoderm
CTGAAACGTACAGACG-1	Angioblasts
CTGAAACGTTCCACGG-1	Visceral endoderm late
CTGAAGTCAAGCGATG-1	Visceral endoderm late
CTGATAGCACGAAATA-1	Gut endoderm
CTGATAGTCCGATATG-1	Visceral endoderm late
CTGATCCAGACAAGCC-1	Angioblasts
CTGATCCAGAGCTGGT-1	Somites
CTGATCCGTACATGTC-1	Hematopoietic/endothelial progenitors
CTGCCTACAAATTGCC-1	Visceral endoderm late
CTGCCTACACTCAGGC-1	Primitive blood early
CTGCCTAGTCGAGATG-1	Primitive blood late
CTGCCTAGTGGCAAAC-1	Primitive blood late
CTGCGGAAGATAGCAT-1	Visceral endoderm late
CTGCGGAAGCGATATA-1	Pharyngeal arch mesoderm
CTGCGGAAGGCGACAT-1	Visceral endoderm late
CTGCGGATCCTTCAAT-1	Primitive blood late
CTGCTGTCAGTTCCCT-1	Amnion mesoderm early
CTGCTGTGTGGGTCAA-1	Visceral endoderm late
CTGGTCTAGTGAATTG-1	Angioblasts
CTGGTCTCAAACCTAC-1	Visceral endoderm late
CTGGTCTCATCTCCCA-1	Primitive blood late
CTGGTCTGTACTCTCC-1	Amnion mesoderm early
CTGGTCTGTAGCGTCC-1	Primitive blood late
CTGGTCTGTGATGTGG-1	Angioblasts
CTGGTCTTCCCTCTTT-1	Primitive blood late
CTGGTCTTCTTATCTG-1	Visceral endoderm late
CTGTGCTAGATCCTGT-1	Visceral endoderm late
CTGTGCTCACATCCAA-1	Neuromesodermal progenitor late
CTGTGCTGTTAGTGGG-1	Primitive blood late
CTGTGCTTCCATGAGT-1	Visceral endoderm early
CTGTTTAAGAGCTATA-1	Primitive blood late
CTGTTTAAGAGTACAT-1	Visceral endoderm late
CTGTTTAAGGTGATTA-1	Primitive blood late
CTGTTTACAAATACAG-1	Primitive blood late
CTGTTTACAGCTATTG-1	Visceral endoderm late
CTGTTTACATTTCAGG-1	Visceral endoderm early
CTGTTTATCAATCACG-1	Visceral endoderm late
CTTAACTAGGTCGGAT-1	Primitive blood late
CTTAACTCACATAACC-1	Primitive blood late
CTTAACTGTAGCTAAA-1	Neural crest
CTTACCGAGCTGCAAG-1	Preplacodal ectoderm
CTTACCGCAGCTTAAC-1	Primitive blood late
CTTACCGGTACCTACA-1	Similar to neural crest
CTTACCGGTTAAGACA-1	Visceral endoderm late
CTTACCGTCGTCTGAA-1	Hematopoietic/endothelial progenitors
CTTCTCTCACAAGTAA-1	Visceral endoderm early
CTTCTCTCACCCATGG-1	Visceral endoderm late
CTTCTCTTCACCTCGT-1	Primitive blood late
CTTCTCTTCGGATGGA-1	Primitive blood late
CTTCTCTTCTTCTGGC-1	Visceral endoderm late
CTTGGCTAGCTAACTC-1	Primitive blood late
CTTGGCTAGTTCGCAT-1	Distal extraembryonic ectoderm
CTTGGCTGTTTACTCT-1	Primitive blood late
CTTTGCGTCGGTGTCG-1	Visceral endoderm late
GAAACTCTCATCACCC-1	Primitive blood late
GAAATGACACTTCGAA-1	Visceral endoderm late
GAACATCGTGACGGTA-1	Visceral endoderm late
GAACATCTCGACGGAA-1	Visceral endoderm late
GAACCTACACCGTTGG-1	Visceral endoderm early
GAACCTACACGAAATA-1	Similar to neural crest
GAACCTATCACTATTC-1	Similar to neural crest
GAACGGAAGAGCTGGT-1	Visceral endoderm late
GAACGGAAGGAGTACC-1	Visceral endoderm late
GAACGGACAAGGACTG-1	Primitive blood late
GAACGGAGTAGCTCCG-1	Primitive blood early
GAACGGAGTCACAAGG-1	Gut endoderm
GAACGGAGTGCTAGCC-1	Primitive blood late
GAACGGAGTTAAGAAC-1	Primitive blood late
GAAGCAGAGAGCTTCT-1	Gut endoderm
GAAGCAGCATAGGATA-1	Trophoblast stem cells
GAAGCAGGTGTTTGGT-1	Primitive blood late
GAAGCAGTCCTTAATC-1	Visceral endoderm early
GAATAAGCACTTCGAA-1	Parietal endoderm
GAATGAAAGTCTCGGC-1	Primitive blood late
GAATGAACATGCCACG-1	Visceral endoderm late
GAATGAATCGCCGTGA-1	Amnion mesoderm early
GACACGCTCCTCTAGC-1	Visceral endoderm late
GACAGAGAGGAGTCTG-1	Fore/midbrain
GACAGAGCACATCCGG-1	Future spinal cord
GACAGAGGTACCATCA-1	Hematopoietic/endothelial progenitors
GACCAATAGCACCGTC-1	Visceral endoderm late
GACCAATAGCCTATGT-1	Primitive blood late
GACCAATAGCTAGTGG-1	Primitive blood late
GACCAATAGCTTATCG-1	Primitive blood late
GACCAATCATGCTGGC-1	Somites
GACCTGGAGCTCCTCT-1	Primitive blood late
GACCTGGTCAGCTCGG-1	Neuromesodermal progenitor late
GACCTGGTCTTCCTTC-1	Visceral endoderm late
GACGCGTGTGCGCTTG-1	Primitive blood late
GACGGCTGTCGAGATG-1	Parietal endoderm
GACGGCTGTTCCACTC-1	Visceral endoderm late
GACGTGCAGTAATCCC-1	Visceral endoderm early
GACGTGCGTACCGTTA-1	Primitive blood late
GACGTGCGTAGCTCCG-1	Preplacodal ectoderm
GACGTGCGTCTGCGGT-1	Allantois
GACGTTACAGCGTTCG-1	Visceral endoderm late
GACGTTAGTAGAAGGA-1	Visceral endoderm late
GACGTTAGTTGGAGGT-1	Visceral endoderm late
GACTAACGTCAGGACA-1	Primitive blood late
GACTAACTCCGAAGAG-1	Somites
GACTACAAGATGCGAC-1	Primitive blood late
GACTACAAGTGCCATT-1	Visceral endoderm early
GACTACACACGGCGTT-1	Preplacodal ectoderm
GACTACAGTACATCCA-1	Visceral endoderm late
GACTACAGTGGTCCGT-1	Visceral endoderm early
GACTACAGTTGGAGGT-1	Visceral endoderm late
GACTACATCCTCTAGC-1	Somites
GACTACATCTCAAACG-1	Primitive blood late
GACTGCGAGGACACCA-1	Primitive blood late
GACTGCGCATTTCAGG-1	Visceral endoderm late
GACTGCGTCTGCCAGG-1	Notochord
GAGCAGAAGCACGCCT-1	Angioblasts
GAGCAGACAAGAAAGG-1	Somites
GAGCAGACAGTTAACC-1	Primitive blood early
GAGCAGACATTCACTT-1	Presomitic mesoderm
GAGCAGAGTACATGTC-1	Primitive blood late
GAGGTGAAGAGCTGCA-1	Primitive blood late
GAGGTGACAATCTACG-1	Visceral endoderm late
GAGTCCGAGCTTTGGT-1	Visceral endoderm late
GAGTCCGAGTGAACAT-1	Visceral endoderm late
GAGTCCGCAGTCAGAG-1	Parietal endoderm
GATCGATCACAGATTC-1	Primitive heart tube
GATCGATCACTTCTGC-1	Gut endoderm
GATCGATTCAAAGTAG-1	Primitive blood late
GATCGATTCGCGTAGC-1	Visceral endoderm late
GATCGCGAGAGCTGCA-1	Primitive blood late
GATCGCGCAAACGTGG-1	Neural ectoderm posterior
GATCGCGTCACCGGGT-1	Visceral endoderm late
GATCTAGCAATCCAAC-1	Primitive blood late
GATCTAGCAATGGACG-1	Visceral endoderm late
GATCTAGCACACAGAG-1	Preplacodal ectoderm
GATCTAGCATCGACGC-1	Visceral endoderm late
GATCTAGTCAACGCTA-1	Amnion mesoderm early
GATCTAGTCCCATTTA-1	Angioblasts
GATGAAAAGGTGATTA-1	Primitive blood late
GATGAAAAGTCGATAA-1	Visceral endoderm early
GATGAAACAGGAACGT-1	Visceral endoderm late
GATGAAACAGGGAGAG-1	Gut endoderm
GATGAAACATCCTAGA-1	Primitive blood late
GATGAAAGTCCATGAT-1	Primitive blood late
GATGAGGCAGCAGTTT-1	Primitive blood early
GATGAGGGTTGATTGC-1	Parietal endoderm
GATGAGGTCACCTCGT-1	Primitive blood late
GATGAGGTCCTGCAGG-1	Primitive blood early
GATGCTACACTTCTGC-1	Primitive blood late
GATGCTATCAATACCG-1	Primitive blood late
GATGCTATCGTGTAGT-1	Primitive blood late
GCAAACTAGAGTACAT-1	Future spinal cord
GCAAACTAGTTCGCAT-1	Amnion mesoderm early
GCAAACTGTTAAGGGC-1	Visceral endoderm late
GCAAACTTCCATTCTA-1	Visceral endoderm late
GCAATCAAGTACGACG-1	Primitive blood late
GCAATCACAAAGAATC-1	Angioblasts
GCAATCACAGTCAGCC-1	Parietal endoderm
GCAATCAGTGATAAAC-1	Visceral endoderm late
GCAATCATCAACCATG-1	Trophoblast stem cells
GCAATCATCCTCTAGC-1	Preplacodal ectoderm
GCACATAAGTACCGGA-1	Posterior lateral plate mesoderm
GCACATACACCTCGTT-1	Primitive blood late
GCACATACATTGAGCT-1	Visceral endoderm late
GCACATAGTCTCATCC-1	Primitive blood late
GCACATATCGTTACGA-1	Visceral endoderm late
GCACTCTCATGTCGAT-1	Future spinal cord
GCACTCTGTATCACCA-1	Gut endoderm
GCACTCTGTTCGGGCT-1	Future spinal cord
GCACTCTTCAACGGGA-1	Visceral endoderm late
GCAGCCAAGCTGGAAC-1	Primitive blood late
GCAGCCAAGTGGCACA-1	Allantois
GCAGCCAGTACTTGAC-1	Visceral endoderm late
GCAGCCAGTTAGTGGG-1	Visceral endoderm late
GCAGCCATCACTGGGC-1	Visceral endoderm late
GCAGCCATCCGTCAAA-1	Visceral endoderm late
GCAGCCATCCTTTCTC-1	Posterior lateral plate mesoderm
GCAGCCATCGGATGGA-1	Primitive blood late
GCAGCCATCGGTCCGA-1	Similar to neural crest
GCAGTTAAGATCCCAT-1	Notochord
GCAGTTACATCACCCT-1	Primitive blood late
GCAGTTAGTCGCATCG-1	Visceral endoderm late
GCAGTTATCCGTTGTC-1	Primitive blood late
GCAGTTATCGGTTCGG-1	Pharyngeal arch mesoderm
GCAGTTATCTTTACGT-1	Angioblasts
GCATACAAGGCTACGA-1	Visceral endoderm late
GCATACAAGTACATGA-1	Visceral endoderm late
GCATACACATCTGGTA-1	Visceral endoderm late
GCATACACATTCCTCG-1	Visceral endoderm late
GCATGATGTAAGAGGA-1	Visceral endoderm late
GCATGATTCCGCGTTT-1	Visceral endoderm late
GCATGCGCAGTATCTG-1	Primitive blood late
GCATGCGTCGGCGGTT-1	Parietal endoderm
GCATGTACAATCTGCA-1	Primitive blood late
GCATGTACACGAGAGT-1	Amnion mesoderm early
GCATGTACAGCGTAAG-1	Primitive blood late
GCCAAATGTACTTAGC-1	Hematopoietic/endothelial progenitors
GCCAAATTCCAAGCCG-1	Visceral endoderm late
GCCTCTAGTAGGAGTC-1	Visceral endoderm late
GCCTCTAGTTTAGCTG-1	Differentiated trophoblasts
GCGACCAGTGTGACCC-1	Primitive blood late
GCGAGAAAGTTGTCGT-1	Amnion mesoderm early
GCGAGAATCGCAAGCC-1	Secondary heart field/splanchnic lateral plate
GCGCAACAGCTAAACA-1	Visceral endoderm late
GCGCAACGTGATGTGG-1	Similar to neural crest
GCGCAACTCTTGCAAG-1	Parietal endoderm
GCGCAGTCACCTTGTC-1	Visceral endoderm late
GCGCAGTCAGGCTCAC-1	Visceral endoderm late
GCGCAGTGTAGCGCAA-1	Primitive blood late
GCGCAGTGTATTCGTG-1	Primitive blood early
GCGCAGTGTCTAAAGA-1	Primitive blood progenitors
GCGCCAAAGATGTGTA-1	Primitive blood late
GCGCCAAGTTCCACAA-1	Visceral endoderm late
GCGCCAATCCCGACTT-1	Visceral endoderm late
GCGCGATAGCTCTCGG-1	Primitive blood late
GCGCGATAGGGCACTA-1	Visceral endoderm late
GCGCGATCACTTCGAA-1	Visceral endoderm late
GCGCGATCATTGGTAC-1	Visceral endoderm early
GCGCGATGTTTGGGCC-1	Visceral endoderm late
GCGGGTTAGGATTCGG-1	Visceral endoderm late
GCGGGTTAGGTCATCT-1	Visceral endoderm late
GCGGGTTCAGGGAGAG-1	Similar to neural crest
GCGGGTTGTCTCAACA-1	Visceral endoderm late
GCGGGTTTCAACCAAC-1	Angioblasts
GCTCCTACACATGGGA-1	Visceral endoderm late
GCTCCTATCTTGCAAG-1	Visceral endoderm late
GCTCTGTCACCGAATT-1	Visceral endoderm late
GCTCTGTCAGCGAACA-1	Angioblasts
GCTGCAGCAAGTCATC-1	Parietal endoderm
GCTGCAGCAGGTTTCA-1	Angioblasts
GCTGCGAAGATGGCGT-1	Primitive blood late
GCTGCGAAGGTGATTA-1	Primitive blood late
GCTGCGAAGTCCGTAT-1	Visceral endoderm early
GCTGCGACACCGTTGG-1	Visceral endoderm late
GCTGCGAGTAAAGTCA-1	Primitive blood late
GCTGCGAGTTCCTCCA-1	Visceral endoderm late
GCTGCGATCTCTTATG-1	Trophoblast stem cells
GCTGCTTAGCAGATCG-1	Visceral endoderm late
GCTGCTTAGGATGGAA-1	Amnion mesoderm early
GCTGCTTCAATTGCTG-1	Visceral endoderm late
GCTGGGTAGCTAGGCA-1	Allantois
GCTGGGTAGTCGATAA-1	Similar to neural crest
GCTGGGTCATGCCACG-1	Primitive blood late
GCTGGGTTCAACACAC-1	Primitive blood late
GCTGGGTTCCACGTTC-1	Neural crest
GCTTGAACAAACTGTC-1	Angioblasts
GCTTGAATCAACGCTA-1	Primitive blood late
GCTTGAATCGCGTTTC-1	Primitive blood late
GGAAAGCGTTACCAGT-1	Primitive blood late
GGAAAGCGTTTACTCT-1	Surface ectoderm
GGAAAGCTCCTAGAAC-1	Pharyngeal arch mesoderm
GGAACTTAGAGCCCAA-1	Primitive blood late
GGAACTTAGGCCCGTT-1	Visceral endoderm late
GGAATAACATTCACTT-1	Primitive blood late
GGAATAAGTAAACCTC-1	Primitive blood late
GGACAAGTCACCGGGT-1	Primitive blood late
GGACAAGTCTAACTTC-1	Angioblasts
GGACAGAAGTCGAGTG-1	Visceral endoderm late
GGACAGAAGTTAGGTA-1	Visceral endoderm late
GGACATTAGAGCCCAA-1	Visceral endoderm late
GGACATTCAGCCTGTG-1	Visceral endoderm late
GGACATTCAGCTGTAT-1	Primitive blood late
GGACATTGTCGTGGCT-1	Neural ectoderm posterior
GGACGTCAGTCAATAG-1	Visceral endoderm late
GGACGTCTCAACACGT-1	Primitive blood late
GGACGTCTCTAACTTC-1	Primitive blood late
GGAGCAAAGGAATTAC-1	Primitive blood late
GGAGCAAGTCCGCTGA-1	Primitive blood late
GGATGTTAGACAAGCC-1	Secondary heart field/splanchnic lateral plate
GGATGTTAGCCGATTT-1	Differentiated trophoblasts
GGATGTTAGCGAGAAA-1	Primitive blood late
GGATGTTCAAGGTGTG-1	Primitive blood late
GGATTACTCACCAGGC-1	Primitive blood late
GGCAATTAGTAACCCT-1	Visceral endoderm late
GGCCGATGTTGGAGGT-1	Primitive blood late
GGCGACTAGCCCAATT-1	Visceral endoderm late
GGCGACTAGGTGCTAG-1	Parietal endoderm
GGCGACTAGTTAACGA-1	Angioblasts
GGCGACTCATAAAGGT-1	Primitive blood late
GGCGTGTCACGACGAA-1	Parietal endoderm
GGCGTGTCAGCCAATT-1	Visceral endoderm late
GGCGTGTGTCAGTGGA-1	Primitive blood late
GGCGTGTGTCCCTTGT-1	Future spinal cord
GGCGTGTTCCTGCTTG-1	Angioblasts
GGCGTGTTCGGAAATA-1	Somites
GGCGTGTTCTCGTATT-1	Primitive blood late
GGCGTGTTCTGCCAGG-1	Angioblasts
GGCTCGATCAAACCAC-1	Visceral endoderm late
GGCTGGTCAAGAGGCT-1	Primitive blood late
GGGAATGAGCAACGGT-1	Parietal endoderm
GGGACCTCAGCCACCA-1	Parietal endoderm
GGGACCTTCACGCATA-1	Visceral endoderm late
GGGAGATAGTCGTTTG-1	Primitive blood early
GGGAGATCACACCGAC-1	Future spinal cord
GGGAGATTCGGCATCG-1	Visceral endoderm late
GGGATGACAGACGTAG-1	Visceral endoderm late
GGGATGACATCGGTTA-1	Visceral endoderm late
GGGCACTAGATAGGAG-1	Primitive heart tube
GGGCACTCAACTGGCC-1	Angioblasts
GGGCACTGTACGCTGC-1	Primitive blood late
GGGCACTTCCGAAGAG-1	Visceral endoderm late
GGGCACTTCTCTGCTG-1	Visceral endoderm late
GGGCACTTCTCTGTCG-1	Visceral endoderm late
GGGCATCAGGAGCGTT-1	Visceral endoderm late
GGGCATCAGTGTTAGA-1	Visceral endoderm late
GGGCATCCACGGCTAC-1	Pharyngeal arch mesoderm
GGGCATCGTTCCACGG-1	Visceral endoderm early
GGGCATCTCAGCTCTC-1	Similar to neural crest
GGGTCTGAGGGTCTCC-1	Angioblasts
GGGTCTGTCACGGTTA-1	Primitive blood early
GGGTTGCCATGGTTGT-1	Pharyngeal arch mesoderm
GGTATTGAGCTAACAA-1	Preplacodal ectoderm
GGTATTGTCTTATCTG-1	Visceral endoderm late
GGTGAAGAGTGCCAGA-1	Visceral endoderm late
GGTGAAGCAGTCGATT-1	Angioblasts
GGTGAAGGTAGCTGCC-1	Parietal endoderm
GGTGCGTCACCTCGGA-1	Preplacodal ectoderm
GGTGCGTCATTTGCCC-1	Visceral endoderm early
GGTGTTAAGATCCCGC-1	Primitive blood late
GGTGTTAAGTACGACG-1	Posterior lateral plate mesoderm
GGTGTTACACCACCAG-1	Notochord
GGTGTTACAGCGATCC-1	Future spinal cord
GGTGTTATCCTATGTT-1	Angioblasts
GGTGTTATCGTCGTTC-1	Primitive blood late
GGTGTTATCTTTAGTC-1	Somites
GTAACGTAGCACCGCT-1	Angioblasts
GTAACGTAGTTTGCGT-1	Future spinal cord
GTAACGTTCTTTCCTC-1	Primitive blood late
GTAACTGAGACTGGGT-1	Primitive blood late
GTAACTGAGGGTGTGT-1	Visceral endoderm late
GTAACTGCAAGAGTCG-1	Gut endoderm
GTAACTGTCGAGAACG-1	Parietal endoderm
GTACGTAAGCTGTCTA-1	Primitive blood late
GTACGTACAAGTAATG-1	Gut endoderm
GTACGTAGTCATATGC-1	Visceral endoderm early
GTACGTAGTCGTCTTC-1	Visceral endoderm late
GTACTCCAGCCCAACC-1	Visceral endoderm late
GTACTCCCATCGGGTC-1	Posterior lateral plate mesoderm
GTACTTTGTAAATGTG-1	Secondary heart field/splanchnic lateral plate
GTAGGCCCAGACGCCT-1	Primitive blood late
GTAGGCCCAGGTTTCA-1	Primitive blood late
GTAGTCACATTCGACA-1	Visceral endoderm late
GTAGTCATCACGATGT-1	Parietal endoderm
GTAGTCATCGGTGTTA-1	Somites
GTAGTCATCGTGGGAA-1	Angioblasts
GTATCTTCAAGCCCAC-1	Gut endoderm
GTATCTTCACCAGATT-1	Primitive blood late
GTATCTTCAGTCAGAG-1	Gut endoderm
GTATCTTGTACTTGAC-1	Primitive blood early
GTATCTTGTGTTGGGA-1	Primitive blood late
GTATTCTGTCGCATAT-1	Allantois
GTATTCTGTCTACCTC-1	Primitive blood late
GTATTCTGTTAAGGGC-1	Visceral endoderm late
GTCAAGTAGGGATACC-1	Primitive blood late
GTCACAAAGTCACGCC-1	Visceral endoderm early
GTCACAACAAGTTGTC-1	Visceral endoderm late
GTCACAATCACGGTTA-1	Primitive blood late
GTCACGGAGAATTCCC-1	Somites
GTCACGGCATTAGCCA-1	Visceral endoderm late
GTCACGGGTCGAGATG-1	Visceral endoderm early
GTCACGGTCAGAAATG-1	Primitive blood late
GTCATTTAGTAGATGT-1	Visceral endoderm late
GTCCTCAAGGTGCTAG-1	Visceral endoderm late
GTCCTCACACCGCTAG-1	Somites
GTCCTCAGTTCGCTAA-1	Secondary heart field/splanchnic lateral plate
GTCGGGTAGCTAAACA-1	Parietal endoderm
GTCGGGTAGTTTAGGA-1	Differentiated trophoblasts
GTCGGGTAGTTTGCGT-1	Visceral endoderm late
GTCGTAAAGTTCGATC-1	Primitive blood late
GTCGTAATCCCAGGTG-1	Primitive blood late
GTCTCGTAGAGTACCG-1	Primitive blood late
GTCTCGTAGATGCGAC-1	Visceral endoderm late
GTCTCGTCACAACGCC-1	Primitive blood late
GTCTCGTGTTGTTTGG-1	Parietal endoderm
GTCTCGTTCACCGGGT-1	Primitive blood late
GTCTTCGAGGAGCGAG-1	Visceral endoderm late
GTCTTCGAGGCTCATT-1	Visceral endoderm late
GTGAAGGGTGGCGAAT-1	Visceral endoderm late
GTGCAGCAGGTGACCA-1	Parietal endoderm
GTGCAGCTCTACGAGT-1	Visceral endoderm late
GTGCGGTGTAGCGCTC-1	Visceral endoderm late
GTGCGGTGTGCGGTAA-1	Visceral endoderm late
GTGCTTCCATGCCACG-1	Gut endoderm
GTGCTTCGTAGGGTAC-1	Visceral endoderm late
GTGCTTCTCCGTCAAA-1	Visceral endoderm late
GTGGGTCAGAAAGTGG-1	Visceral endoderm late
GTGGGTCAGAGAACAG-1	Visceral endoderm late
GTGGGTCCAAATCCGT-1	Visceral endoderm late
GTGGGTCCAAGGCTCC-1	Visceral endoderm late
GTGGGTCGTTCAACCA-1	Angioblasts
GTGTGCGCATCATCCC-1	Primitive blood late
GTGTTAGAGAGGTTAT-1	Differentiated trophoblasts
GTGTTAGAGCGAAGGG-1	Distal extraembryonic ectoderm
GTGTTAGAGTAGCCGA-1	Visceral endoderm late
GTTAAGCAGGCAGGTT-1	Primitive blood late
GTTAAGCAGTCCCACG-1	Angioblasts
GTTAAGCCAAGTCTGT-1	Visceral endoderm late
GTTAAGCTCCGCGGTA-1	Visceral endoderm late
GTTAAGCTCGTCCAGG-1	Primitive blood late
GTTACAGAGTCATCCA-1	Amnion mesoderm early
GTTACAGCAGCCACCA-1	Primitive blood late
GTTACAGCATGATCCA-1	Angioblasts
GTTCATTAGCTACCGC-1	Visceral endoderm late
GTTCATTAGTTGAGTA-1	Trophoblast stem cells
GTTCATTCAATCGAAA-1	Similar to neural crest
GTTCATTCAATGTAAG-1	Primitive blood late
GTTCATTCACATTCGA-1	Amnion mesoderm early
GTTCATTTCAGTGCAT-1	Primitive blood late
GTTCATTTCATGTAGC-1	Visceral endoderm early
GTTCATTTCTAACGGT-1	Similar to neural crest
GTTCGGGAGATCGGGT-1	Visceral endoderm early
GTTCGGGAGGGCATGT-1	Primitive blood late
GTTCGGGCAGTGGAGT-1	Amnion mesoderm early
GTTCGGGCAGTTAACC-1	Visceral endoderm late
GTTCTCGAGCGATGAC-1	Visceral endoderm late
GTTCTCGAGTGTCTCA-1	Primitive blood late
GTTCTCGGTTCTGAAC-1	Visceral endoderm late
GTTTCTAAGCTAGGCA-1	Visceral endoderm late
GTTTCTAAGTAGATGT-1	Parietal endoderm
GTTTCTACAATTGCTG-1	Primitive blood late
TAAACCGAGCCGATTT-1	Amnion mesoderm early
TAAACCGAGGTTACCT-1	Visceral endoderm late
TAAACCGCACACTGCG-1	Similar to neural crest
TAAACCGCAGGTTTCA-1	Visceral endoderm late
TAAACCGGTGCACGAA-1	Visceral endoderm late
TAAGAGACAGGTCTCG-1	Visceral endoderm early
TAAGCGTGTTGCGTTA-1	Visceral endoderm late
TAAGCGTTCCTGTAGA-1	Primitive blood late
TAAGCGTTCTCCGGTT-1	Differentiated trophoblasts
TAAGTGCAGCCAGAAC-1	Visceral endoderm late
TAAGTGCAGGGATGGG-1	Primitive blood late
TAAGTGCCACGAGGTA-1	Visceral endoderm early
TAAGTGCCACTTCTGC-1	Visceral endoderm late
TAAGTGCCATCGGTTA-1	Primitive blood late
TAAGTGCGTGCCTGGT-1	Visceral endoderm late
TAAGTGCTCTCGCATC-1	Neural crest
TACAGTGAGATCTGCT-1	Angioblasts
TACAGTGCATGGGAAC-1	Visceral endoderm late
TACAGTGCATTTGCCC-1	Primitive blood late
TACAGTGGTCCAGTAT-1	Primitive blood late
TACAGTGGTTGGTTTG-1	Primitive blood late
TACCTATCAGCGTAAG-1	Fore/midbrain
TACCTATGTCCGACGT-1	Primitive blood late
TACCTTAGTAATAGCA-1	Primitive blood late
TACGGATAGGGTTTCT-1	Posterior lateral plate mesoderm
TACGGATGTTCCAACA-1	Visceral endoderm late
TACGGATTCGATAGAA-1	Visceral endoderm late
TACGGATTCGCGATCG-1	Angioblasts
TACGGGCCATTTCACT-1	Primitive blood late
TACGGGCGTAAACCTC-1	Trophoblast stem cells
TACGGGCGTATAATGG-1	Parietal endoderm
TACGGGCGTCAGAGGT-1	Visceral endoderm late
TACGGGCTCACAAACC-1	Visceral endoderm late
TACGGTAAGAGGACGG-1	Visceral endoderm late
TACGGTAAGTGGACGT-1	Visceral endoderm late
TACGGTAGTACTTGAC-1	Gut endoderm
TACTCATAGATGGCGT-1	Hematopoietic/endothelial progenitors
TACTCATAGTGCGATG-1	Visceral endoderm early
TACTCGCAGTCCATAC-1	Visceral endoderm late
TACTCGCAGTCCCACG-1	Visceral endoderm late
TACTCGCCAGTGGGAT-1	Distal extraembryonic ectoderm
TACTCGCGTAACGTTC-1	Visceral endoderm late
TACTCGCTCCAAATGC-1	Visceral endoderm late
TACTCGCTCCCATTTA-1	Similar to neural crest
TACTTACGTCCATGAT-1	Visceral endoderm late
TACTTACGTGTGCGTC-1	Preplacodal ectoderm
TACTTGTGTACCGCTG-1	Parietal endoderm
TACTTGTGTTCCACAA-1	Somites
TACTTGTTCCTCAACC-1	Angioblasts
TAGACCACAAGGTTTC-1	Visceral endoderm late
TAGCCGGGTCCAGTAT-1	Visceral endoderm late
TAGGCATTCCCAACGG-1	Visceral endoderm late
TAGTGGTCACCCATGG-1	Future spinal cord
TAGTGGTTCGCCAAAT-1	Visceral endoderm late
TAGTGGTTCTGCTGTC-1	Differentiated trophoblasts
TAGTTGGGTGAAGGCT-1	Visceral endoderm late
TAGTTGGTCCTGCAGG-1	Gut endoderm
TAGTTGGTCTGTGCAA-1	Angioblasts
TATCAGGTCACTCCTG-1	Visceral endoderm late
TATCAGGTCCCTTGTG-1	Visceral endoderm late
TATCAGGTCGCCCTTA-1	Visceral endoderm late
TATCTCAAGGCCGAAT-1	Angioblasts
TATCTCACAAGCTGAG-1	Future spinal cord
TATCTCATCACCGTAA-1	Visceral endoderm early
TATGCCCAGCAGGTCA-1	Amnion mesoderm early
TATGCCCTCAGAAATG-1	Primitive blood late
TATGCCCTCCACTCCA-1	Somites
TATGCCCTCCTGCCAT-1	Primitive blood late
TATGCCCTCTGACCTC-1	Preplacodal ectoderm
TCAACGAGTTTGTTGG-1	Visceral endoderm late
TCAATCTAGTTGTAGA-1	Visceral endoderm late
TCAATCTCACGGCCAT-1	Visceral endoderm late
TCAATCTCAGTTCCCT-1	Trophoblast stem cells
TCAATCTGTCACCCAG-1	Gut endoderm
TCACAAGAGTGTCTCA-1	Visceral endoderm late
TCACGAACACGTCTCT-1	Visceral endoderm early
TCACGAAGTATCGCAT-1	Visceral endoderm late
TCACGAATCATGTCTT-1	Gut endoderm
TCAGATGAGAGCTATA-1	Primitive blood late
TCAGATGAGCGATATA-1	Visceral endoderm late
TCAGATGCATACCATG-1	Differentiated trophoblasts
TCAGATGTCTAACTGG-1	Visceral endoderm late
TCAGCAACACGTCAGC-1	Primitive blood late
TCAGCAAGTACAGTTC-1	Primitive blood late
TCAGCAAGTAGCTGCC-1	Visceral endoderm late
TCAGCAAGTCGCGTGT-1	Primitive blood late
TCAGCAATCCGCATCT-1	Primitive blood late
TCAGCAATCCTTTCTC-1	Amnion mesoderm early
TCAGCAATCGGCGCAT-1	Visceral endoderm late
TCAGCTCGTAGCAAAT-1	Visceral endoderm late
TCAGGATAGGCAAAGA-1	Neural ectoderm posterior
TCAGGATCAATAAGCA-1	Primitive blood late
TCAGGATCACCAGGCT-1	Visceral endoderm late
TCAGGATGTGAGGGAG-1	Primitive blood late
TCAGGATTCGATCCCT-1	Similar to neural crest
TCAGGTAAGGCCCGTT-1	Primitive blood late
TCAGGTAGTGAGCGAT-1	Pharyngeal arch mesoderm
TCAGGTAGTTGTTTGG-1	Primitive heart tube
TCAGGTATCAGCTCTC-1	Primitive blood late
TCATTACAGAGTAATC-1	Primitive blood late
TCATTACGTCACACGC-1	Visceral endoderm late
TCATTACGTGTCGCTG-1	Visceral endoderm late
TCCACACAGTTCCACA-1	Visceral endoderm late
TCCACACTCACAGTAC-1	Visceral endoderm late
TCCCGATCACTTCGAA-1	Differentiated trophoblasts
TCCCGATTCCAAAGTC-1	Primitive blood late
TCGAGGCAGTCATCCA-1	Visceral endoderm late
TCGAGGCCATGGTCAT-1	Gut endoderm
TCGAGGCTCACAGTAC-1	Visceral endoderm late
TCGCGAGAGAGGGATA-1	Visceral endoderm late
TCGCGAGAGGACCACA-1	Parietal endoderm
TCGCGAGGTGTGGCTC-1	Parietal endoderm
TCGCGTTAGTGTTGAA-1	Visceral endoderm late
TCGCGTTCACATGACT-1	Visceral endoderm late
TCGCGTTCATTGTGCA-1	Visceral endoderm late
TCGCGTTTCTACCAGA-1	Angioblasts
TCGCGTTTCTCCGGTT-1	Similar to neural crest
TCGGGACAGCGCCTTG-1	Visceral endoderm late
TCGGGACAGCTGATAA-1	Visceral endoderm late
TCGGGACCACCTTGTC-1	Parietal endoderm
TCGGGACCACGGTTTA-1	Visceral endoderm late
TCGGTAAGTATTCTCT-1	Primitive blood late
TCGGTAAGTTGTTTGG-1	Primitive heart tube
TCGTACCAGGCACATG-1	Visceral endoderm early
TCGTACCCAGGTGCCT-1	Primitive blood late
TCGTACCGTAGGCATG-1	Primitive blood late
TCGTACCGTAGGGTAC-1	Primitive blood late
TCGTAGAGTAAGGGCT-1	Visceral endoderm late
TCGTAGATCACTCTTA-1	Visceral endoderm late
TCTATTGTCTGGTGTA-1	Primitive blood late
TCTCATACAAATTGCC-1	Visceral endoderm late
TCTCATACAGGTGCCT-1	Visceral endoderm early
TCTCTAAAGTCGTTTG-1	Visceral endoderm late
TCTCTAAAGTGAATTG-1	Amnion mesoderm early
TCTCTAACATATGAGA-1	Primitive blood late
TCTCTAACATTACCTT-1	Visceral endoderm late
TCTGAGAGTCAAAGCG-1	Visceral endoderm late
TCTGAGAGTGGCAAAC-1	Parietal endoderm
TCTGAGAGTTACAGAA-1	Primitive blood late
TCTGAGATCATGCATG-1	Somites
TCTGGAAAGAAGGACA-1	Angioblasts
TCTGGAACAAACGTGG-1	Angioblasts
TCTGGAACAGATGGCA-1	Primitive blood late
TCTGGAACATAGACTC-1	Visceral endoderm late
TCTTCGGAGGTAGCTG-1	Visceral endoderm late
TCTTCGGCATATACGC-1	Future spinal cord
TCTTCGGGTCAACTGT-1	Preplacodal ectoderm
TCTTCGGGTGCTGTAT-1	Neural crest
TCTTTCCGTGTGACCC-1	Primitive blood late
TGAAAGAAGATCCTGT-1	Visceral endoderm late
TGAAAGATCCACGTTC-1	Gut endoderm
TGACAACAGATGTCGG-1	Visceral endoderm late
TGACAACAGGAGTTTA-1	Allantois
TGACAACGTGAAAGAG-1	Primitive blood late
TGACAACGTGGCCCTA-1	Visceral endoderm late
TGACAACGTGGTCTCG-1	Visceral endoderm early
TGACGGCAGAAGCCCA-1	Visceral endoderm late
TGACGGCCAAAGCAAT-1	Primitive blood late
TGACGGCTCCCGACTT-1	Visceral endoderm late
TGACTAGGTAGAAAGG-1	Visceral endoderm late
TGACTAGGTCCGAATT-1	Primitive blood early
TGACTAGTCTCGCTTG-1	Angioblasts
TGACTTTAGGATGGTC-1	Visceral endoderm late
TGACTTTCAAGCGATG-1	Future spinal cord
TGACTTTCACACCGCA-1	Primitive blood late
TGAGAGGCAGGTCTCG-1	Visceral endoderm late
TGAGAGGCATAGACTC-1	Angioblasts
TGAGAGGCATCGATGT-1	Visceral endoderm late
TGAGAGGTCAGTGCAT-1	Primitive blood late
TGAGAGGTCGTAGATC-1	Amnion mesoderm early
TGAGCATGTCCAAGTT-1	Angioblasts
TGAGCCGAGAAGGGTA-1	Visceral endoderm late
TGAGCCGAGTTCGATC-1	Visceral endoderm late
TGAGCCGGTGACTCAT-1	Similar to neural crest
TGAGGGAAGACGACGT-1	Allantois
TGAGGGAAGCGTTGCC-1	Neural crest
TGAGGGAAGTATCTCG-1	Visceral endoderm late
TGAGGGATCTAACCGA-1	Gut endoderm
TGATTTCAGTATCGAA-1	Visceral endoderm late
TGATTTCCAGCTATTG-1	Primitive blood late
TGCACCTTCATGCTCC-1	Visceral endoderm late
TGCCAAAAGTTAGGTA-1	Primitive blood late
TGCCAAACACAAGTAA-1	Primitive blood late
TGCCAAACACGGTTTA-1	Visceral endoderm late
TGCCAAATCAAACGGG-1	Visceral endoderm late
TGCCCATCAACTGCGC-1	Visceral endoderm late
TGCCCATCAATGAAAC-1	Visceral endoderm late
TGCCCATTCCGCGTTT-1	Visceral endoderm late
TGCCCTAAGACAAAGG-1	Visceral endoderm late
TGCCCTAAGGTCATCT-1	Angioblasts
TGCCCTACATAACCTG-1	Primitive blood late
TGCCCTATCCTCCTAG-1	Primitive blood late
TGCGCAGAGGCGACAT-1	Somites
TGCGGGTCAAGCCTAT-1	Differentiated trophoblasts
TGCGGGTTCAGTCAGT-1	Amnion mesoderm early
TGCGGGTTCTGTCTAT-1	Differentiated trophoblasts
TGCGTGGAGTGATCGG-1	Primitive blood late
TGCGTGGGTCTGGAGA-1	Primitive blood late
TGCGTGGGTGCACTTA-1	Visceral endoderm late
TGCGTGGGTTGCGTTA-1	Visceral endoderm early
TGCGTGGTCTTTACAC-1	Primitive blood late
TGCTACCTCCCAAGAT-1	Visceral endoderm early
TGCTGCTAGTGCGTGA-1	Allantois
TGCTGCTCATATGCTG-1	Visceral endoderm late
TGCTGCTTCGAGGTAG-1	Future spinal cord
TGCTGCTTCGGTGTTA-1	Primitive blood late
TGGACGCAGATGTGTA-1	Primitive blood progenitors
TGGACGCCATAACCTG-1	Primitive blood late
TGGACGCGTCCGAATT-1	Visceral endoderm late
TGGACGCTCTTACCTA-1	Primitive blood late
TGGCCAGGTTCTCATT-1	Visceral endoderm late
TGGCCAGTCAGCCTAA-1	Similar to neural crest
TGGCGCACAGTATCTG-1	Angioblasts
TGGCGCAGTGGTCTCG-1	Similar to neural crest
TGGCGCATCAACGCTA-1	Primitive blood late
TGGCGCATCACCAGGC-1	Primitive blood early
TGGCTGGAGTGTACCT-1	Primitive blood progenitors
TGGCTGGGTCCGACGT-1	Visceral endoderm late
TGGCTGGGTGGTTTCA-1	Angioblasts
TGGCTGGTCCTTTCGG-1	Differentiated trophoblasts
TGGGAAGCAATCCAAC-1	Primitive blood late
TGGGAAGGTAATCGTC-1	Primitive heart tube
TGGGAAGTCAGTGTTG-1	Angioblasts
TGGGCGTGTGAGTATA-1	Visceral endoderm late
TGGGCGTGTGCACGAA-1	Somites
TGGGCGTTCGTCGTTC-1	Visceral endoderm early
TGGGCGTTCTGCTGCT-1	Visceral endoderm late
TGGTTAGAGGACCACA-1	Primitive heart tube
TGGTTAGAGGGCTCTC-1	Primitive blood late
TGGTTAGCAATCGGTT-1	Primitive blood late
TGGTTAGTCCGTTGCT-1	Visceral endoderm late
TGGTTCCAGCCGGTAA-1	Visceral endoderm late
TGGTTCCAGTGAAGAG-1	Differentiated trophoblasts
TGGTTCCCAAGCCATT-1	Visceral endoderm late
TGGTTCCCACTTACGA-1	Angioblasts
TGTATTCAGAAGATTC-1	Visceral endoderm late
TGTATTCAGCGTGAAC-1	Primitive blood late
TGTATTCGTCACCCAG-1	Visceral endoderm late
TGTATTCTCATCTGCC-1	Visceral endoderm late
TGTATTCTCCAGAAGG-1	Primitive blood late
TGTCCCACACTTCTGC-1	Visceral endoderm late
TGTCCCACATTAACCG-1	Visceral endoderm late
TGTCCCAGTCACTGGC-1	Visceral endoderm late
TGTCCCAGTTCTGGTA-1	Visceral endoderm late
TGTGGTACACCACGTG-1	Primitive blood late
TGTGGTATCGGTTAAC-1	Amnion mesoderm early
TGTGGTATCGTTGCCT-1	Visceral endoderm late
TGTGTTTAGACTAGGC-1	Amnion mesoderm early
TGTGTTTCAGCGTAAG-1	Future spinal cord
TTAACTCGTAAACACA-1	Angioblasts
TTAGGACAGCTCCCAG-1	Visceral endoderm late
TTAGGACAGGCAATTA-1	Primitive blood progenitors
TTAGGACGTAAACCTC-1	Visceral endoderm late
TTAGGACGTCTGATCA-1	Visceral endoderm late
TTAGGCAGTGCACTTA-1	Primitive blood late
TTAGGCATCCTTTCGG-1	Visceral endoderm late
TTAGTTCAGATATACG-1	Visceral endoderm late
TTAGTTCAGCGATCCC-1	Visceral endoderm late
TTAGTTCGTGGCCCTA-1	Visceral endoderm late
TTATGCTTCAACACTG-1	Visceral endoderm late
TTCCCAGAGACAGACC-1	Primitive blood late
TTCCCAGGTCAGGACA-1	Visceral endoderm early
TTCGAAGAGCCAACAG-1	Primitive blood late
TTCGAAGAGTTTCCTT-1	Angioblasts
TTCGAAGCAACACGCC-1	Visceral endoderm late
TTCGAAGGTCGGGTCT-1	Visceral endoderm late
TTCGAAGTCACTATTC-1	Visceral endoderm late
TTCGAAGTCGGTTAAC-1	Visceral endoderm late
TTCGAAGTCTGCGTAA-1	Parietal endoderm
TTCGGTCGTTCTGGTA-1	Primitive blood late
TTCTACACATTAGGCT-1	Visceral endoderm early
TTCTACACATTTCACT-1	Gut endoderm
TTCTACAGTAAGTGTA-1	Visceral endoderm late
TTCTACAGTATCACCA-1	Angioblasts
TTCTACAGTCGAGTTT-1	Visceral endoderm early
TTCTACATCACCATAG-1	Amnion mesoderm early
TTCTCAACAGGAATCG-1	Neural crest
TTCTCAACAGTTCCCT-1	Primitive blood late
TTCTCAAGTAGGAGTC-1	Angioblasts
TTCTCAAGTCTGCGGT-1	Visceral endoderm late
TTCTCAATCACATGCA-1	Visceral endoderm late
TTCTCCTAGTACGCCC-1	Visceral endoderm late
TTCTCCTCAATGTAAG-1	Visceral endoderm late
TTCTTAGTCTGCTGTC-1	Similar to neural crest
TTGACTTAGTTAGGTA-1	Visceral endoderm late
TTGACTTTCCGTTGCT-1	Neuromesodermal progenitor late
TTGCCGTCATGCCCGA-1	Visceral endoderm late
TTGCGTCAGGATCGCA-1	Visceral endoderm early
TTGCGTCCATAGAAAC-1	Amnion mesoderm early
TTGCGTCGTCCGTTAA-1	Amnion mesoderm early
TTGCGTCTCACAGGCC-1	Primitive blood late
TTGGAACGTATATGGA-1	Visceral endoderm early
TTGGAACGTCCTAGCG-1	Visceral endoderm early
TTGGCAAGTGAGCGAT-1	Future spinal cord
TTGTAGGAGGCTCAGA-1	Primitive blood late
TTGTAGGGTGTTAAGA-1	Visceral endoderm late
TTTACTGCAAAGGAAG-1	Primitive blood late
TTTACTGCAAGGACTG-1	Primitive blood late
TTTACTGTCACGCGGT-1	Angioblasts
TTTGCGCCACGACTCG-1	Preplacodal ectoderm
TTTGCGCCATCTCCCA-1	Secondary heart field/splanchnic lateral plate
TTTGCGCCATTAGCCA-1	Allantois
TTTGCGCGTTCAGTAC-1	Primitive blood early
TTTGGTTCAGCTATTG-1	Similar to neural crest
TTTGGTTCAGTCGTGC-1	Visceral endoderm late
TTTGGTTTCATGCAAC-1	Visceral endoderm late
TTTGGTTTCGGGAGTA-1	Pharyngeal arch mesoderm
TTTGTCAGTTGCGCAC-1	Pharyngeal arch mesoderm
TTTGTCATCTAGCACA-1	Visceral endoderm late
